,data,Regione,Dose1,Dose2,DoseUnica,Booster1,Booster3Dosi,Booster2,Dose1Cum,Dose2Cum,DoseUnicaCum,Booster1Cum,Booster3DosiCum,Booster2Cum
0,2020-12-27,Emilia Romagna,973,0,0,0,0,0,973,0,0,0,0,0
2,2020-12-28,Emilia Romagna,1,0,0,0,0,0,974,0,0,0,0,0
5,2020-12-30,Emilia Romagna,2,0,0,0,0,0,976,0,0,0,0,0
7,2020-12-31,Emilia Romagna,2216,0,7,0,0,0,3192,0,7,0,0,0
10,2021-01-02,Emilia Romagna,2380,0,1,0,0,0,5572,0,8,0,0,0
12,2021-01-03,Emilia Romagna,2766,0,0,0,0,0,8338,0,8,0,0,0
14,2021-01-04,Emilia Romagna,7311,0,14,0,0,0,15649,0,22,0,0,0
16,2021-01-05,Emilia Romagna,9361,0,20,0,0,0,25010,0,42,0,0,0
18,2021-01-06,Emilia Romagna,8252,0,56,0,0,0,33262,0,98,0,0,0
20,2021-01-07,Emilia Romagna,10292,0,18,0,0,0,43554,0,116,0,0,0
22,2021-01-08,Emilia Romagna,10838,0,59,0,0,0,54392,0,175,0,0,0
24,2021-01-09,Emilia Romagna,10005,0,24,0,0,0,64397,0,199,0,0,0
26,2021-01-10,Emilia Romagna,7175,0,12,0,0,0,71572,0,211,0,0,0
28,2021-01-11,Emilia Romagna,9341,0,22,0,0,0,80913,0,233,0,0,0
30,2021-01-12,Emilia Romagna,9459,0,28,0,0,0,90372,0,261,0,0,0
32,2021-01-13,Emilia Romagna,9039,0,50,0,0,0,99411,0,311,0,0,0
34,2021-01-14,Emilia Romagna,8098,0,41,0,0,0,107509,0,352,0,0,0
36,2021-01-15,Emilia Romagna,7748,0,14,0,0,0,115257,0,366,0,0,0
38,2021-01-16,Emilia Romagna,5593,0,40,0,0,0,120850,0,406,0,0,0
40,2021-01-17,Emilia Romagna,2649,249,4,0,0,0,123499,249,410,0,0,0
42,2021-01-18,Emilia Romagna,2448,681,9,0,0,0,125947,930,419,0,0,0
44,2021-01-19,Emilia Romagna,2035,17,2,0,0,0,127982,947,421,0,0,0
46,2021-01-20,Emilia Romagna,1331,1,2,0,0,0,129313,948,423,0,0,0
48,2021-01-21,Emilia Romagna,823,1349,1,0,0,0,130136,2297,424,0,0,0
50,2021-01-22,Emilia Romagna,1085,748,5,0,0,0,131221,3045,429,0,0,0
52,2021-01-23,Emilia Romagna,437,2009,1,0,0,0,131658,5054,430,0,0,0
54,2021-01-24,Emilia Romagna,299,2149,1,0,0,0,131957,7203,431,0,0,0
56,2021-01-25,Emilia Romagna,202,6269,2,0,0,0,132159,13472,433,0,0,0
58,2021-01-26,Emilia Romagna,206,8131,3,0,0,0,132365,21603,436,0,0,0
60,2021-01-27,Emilia Romagna,459,7912,1,0,0,0,132824,29515,437,0,0,0
62,2021-01-28,Emilia Romagna,342,9916,5,0,0,0,133166,39431,442,0,0,0
64,2021-01-29,Emilia Romagna,285,10155,2,0,0,0,133451,49586,444,0,0,0
66,2021-01-30,Emilia Romagna,135,9970,1,0,0,0,133586,59556,445,0,0,0
68,2021-01-31,Emilia Romagna,240,7478,0,0,0,0,133826,67034,445,0,0,0
70,2021-02-01,Emilia Romagna,355,9980,2,0,0,0,134181,77014,447,0,0,0
72,2021-02-02,Emilia Romagna,533,8968,2,0,0,0,134714,85982,449,0,0,0
74,2021-02-03,Emilia Romagna,963,8396,2,0,0,0,135677,94378,451,0,0,0
76,2021-02-04,Emilia Romagna,1241,8702,2,0,0,0,136918,103080,453,0,0,0
78,2021-02-05,Emilia Romagna,1618,7697,6,0,0,0,138536,110777,459,0,0,0
80,2021-02-06,Emilia Romagna,2109,5497,7,0,0,0,140645,116274,466,0,0,0
82,2021-02-07,Emilia Romagna,1723,3071,5,0,0,0,142368,119345,471,0,0,0
84,2021-02-08,Emilia Romagna,2319,2925,5,0,0,0,144687,122270,476,0,0,0
86,2021-02-09,Emilia Romagna,2306,1856,6,0,0,0,146993,124126,482,0,0,0
88,2021-02-10,Emilia Romagna,2757,1263,8,0,0,0,149750,125389,490,0,0,0
90,2021-02-11,Emilia Romagna,3396,845,21,0,0,0,153146,126234,511,0,0,0
92,2021-02-12,Emilia Romagna,3897,1408,35,0,0,0,157043,127642,546,0,0,0
94,2021-02-13,Emilia Romagna,3020,599,19,0,0,0,160063,128241,565,0,0,0
96,2021-02-14,Emilia Romagna,1275,120,13,0,0,0,161338,128361,578,0,0,0
98,2021-02-15,Emilia Romagna,2705,125,79,0,0,0,164043,128486,657,0,0,0
100,2021-02-16,Emilia Romagna,5220,531,27,0,0,0,169263,129017,684,0,0,0
102,2021-02-17,Emilia Romagna,5746,774,28,0,0,0,175009,129791,712,0,0,0
104,2021-02-18,Emilia Romagna,6437,592,22,0,0,0,181446,130383,734,0,0,0
106,2021-02-19,Emilia Romagna,6795,514,27,0,0,0,188241,130897,761,0,0,0
108,2021-02-20,Emilia Romagna,5037,263,21,0,0,0,193278,131160,782,0,0,0
110,2021-02-21,Emilia Romagna,3997,440,15,0,0,0,197275,131600,797,0,0,0
112,2021-02-22,Emilia Romagna,7182,273,36,0,0,0,204457,131873,833,0,0,0
114,2021-02-23,Emilia Romagna,7803,386,30,0,0,0,212260,132259,863,0,0,0
116,2021-02-24,Emilia Romagna,8439,888,35,0,0,0,220699,133147,898,0,0,0
118,2021-02-25,Emilia Romagna,8247,955,49,0,0,0,228946,134102,947,0,0,0
120,2021-02-26,Emilia Romagna,8546,1056,44,0,0,0,237492,135158,991,0,0,0
122,2021-02-27,Emilia Romagna,9169,1742,61,0,0,0,246661,136900,1052,0,0,0
124,2021-02-28,Emilia Romagna,4945,1854,37,0,0,0,251606,138754,1089,0,0,0
126,2021-03-01,Emilia Romagna,7795,2265,49,0,0,0,259401,141019,1138,0,0,0
128,2021-03-02,Emilia Romagna,10485,2087,110,0,0,0,269886,143106,1248,0,0,0
130,2021-03-03,Emilia Romagna,13315,2487,115,0,0,0,283201,145593,1363,0,0,0
132,2021-03-04,Emilia Romagna,13317,3022,165,0,0,0,296518,148615,1528,0,0,0
134,2021-03-05,Emilia Romagna,14220,3516,205,0,0,0,310738,152131,1733,0,0,0
136,2021-03-06,Emilia Romagna,18081,2746,236,0,0,0,328819,154877,1969,0,0,0
138,2021-03-07,Emilia Romagna,6248,1529,78,0,0,0,335067,156406,2047,0,0,0
140,2021-03-08,Emilia Romagna,9429,2675,134,0,0,0,344496,159081,2181,0,0,0
142,2021-03-09,Emilia Romagna,10709,3956,163,0,0,0,355205,163037,2344,0,0,0
144,2021-03-10,Emilia Romagna,12922,5649,257,0,0,0,368127,168686,2601,0,0,0
146,2021-03-11,Emilia Romagna,11396,5862,253,0,0,0,379523,174548,2854,0,0,0
148,2021-03-12,Emilia Romagna,11269,6728,351,0,0,0,390792,181276,3205,0,0,0
150,2021-03-13,Emilia Romagna,10560,5317,283,0,0,0,401352,186593,3488,0,0,0
152,2021-03-14,Emilia Romagna,4929,3801,84,0,0,0,406281,190394,3572,0,0,0
154,2021-03-15,Emilia Romagna,6847,6516,120,0,0,0,413128,196910,3692,0,0,0
156,2021-03-16,Emilia Romagna,4864,7319,75,0,0,0,417992,204229,3767,0,0,0
158,2021-03-17,Emilia Romagna,5799,7858,68,0,0,0,423791,212087,3835,0,0,0
160,2021-03-18,Emilia Romagna,5675,8013,101,0,0,0,429466,220100,3936,0,0,0
162,2021-03-19,Emilia Romagna,7773,7972,185,0,0,0,437239,228072,4121,0,0,0
164,2021-03-20,Emilia Romagna,8939,6967,193,0,0,0,446178,235039,4314,0,0,0
166,2021-03-21,Emilia Romagna,7242,4605,118,0,0,0,453420,239644,4432,0,0,0
168,2021-03-22,Emilia Romagna,10603,6876,193,0,0,0,464023,246520,4625,0,0,0
170,2021-03-23,Emilia Romagna,11906,6698,214,0,0,0,475929,253218,4839,0,0,0
172,2021-03-24,Emilia Romagna,13605,7393,266,0,0,0,489534,260611,5105,0,0,0
174,2021-03-25,Emilia Romagna,14197,6999,309,0,0,0,503731,267610,5414,0,0,0
176,2021-03-26,Emilia Romagna,16976,6446,334,0,0,0,520707,274056,5748,0,0,0
178,2021-03-27,Emilia Romagna,14495,6915,287,0,0,0,535202,280971,6035,0,0,0
180,2021-03-28,Emilia Romagna,9523,3900,155,0,0,0,544725,284871,6190,0,0,0
182,2021-03-29,Emilia Romagna,16518,4667,283,0,0,0,561243,289538,6473,0,0,0
184,2021-03-30,Emilia Romagna,17963,5046,360,0,0,0,579206,294584,6833,0,0,0
186,2021-03-31,Emilia Romagna,19478,5475,368,0,0,0,598684,300059,7201,0,0,0
188,2021-04-01,Emilia Romagna,19046,4563,379,0,0,0,617730,304622,7580,0,0,0
190,2021-04-02,Emilia Romagna,18540,4492,393,0,0,0,636270,309114,7973,0,0,0
192,2021-04-03,Emilia Romagna,15952,3805,259,0,0,0,652222,312919,8232,0,0,0
194,2021-04-04,Emilia Romagna,7521,2278,94,0,0,0,659743,315197,8326,0,0,0
196,2021-04-05,Emilia Romagna,11775,2895,197,0,0,0,671518,318092,8523,0,0,0
198,2021-04-06,Emilia Romagna,19711,4754,317,0,0,0,691229,322846,8840,0,0,0
200,2021-04-07,Emilia Romagna,20445,6091,380,0,0,0,711674,328937,9220,0,0,0
202,2021-04-08,Emilia Romagna,25308,5339,774,0,0,0,736982,334276,9994,0,0,0
204,2021-04-09,Emilia Romagna,19506,5764,542,0,0,0,756488,340040,10536,0,0,0
206,2021-04-10,Emilia Romagna,16448,4147,351,0,0,0,772936,344187,10887,0,0,0
208,2021-04-11,Emilia Romagna,11977,3047,266,0,0,0,784913,347234,11153,0,0,0
210,2021-04-12,Emilia Romagna,14432,4459,383,0,0,0,799345,351693,11536,0,0,0
212,2021-04-13,Emilia Romagna,19008,4343,385,0,0,0,818353,356036,11921,0,0,0
214,2021-04-14,Emilia Romagna,20496,6111,460,0,0,0,838849,362147,12381,0,0,0
216,2021-04-15,Emilia Romagna,19227,9684,470,0,0,0,858076,371831,12851,0,0,0
218,2021-04-16,Emilia Romagna,19999,8841,408,0,0,0,878075,380672,13259,0,0,0
220,2021-04-17,Emilia Romagna,17557,9357,416,0,0,0,895632,390029,13675,0,0,0
222,2021-04-18,Emilia Romagna,12367,4938,242,0,0,0,907999,394967,13917,0,0,0
224,2021-04-19,Emilia Romagna,14329,6278,313,0,0,0,922328,401245,14230,0,0,0
226,2021-04-20,Emilia Romagna,13888,8366,410,0,0,0,936216,409611,14640,0,0,0
228,2021-04-21,Emilia Romagna,13870,9738,374,0,0,0,950086,419349,15014,0,0,0
230,2021-04-22,Emilia Romagna,14602,14086,381,0,0,0,964688,433435,15395,0,0,0
232,2021-04-23,Emilia Romagna,14302,14897,392,0,0,0,978990,448332,15787,0,0,0
234,2021-04-24,Emilia Romagna,14054,14242,366,0,0,0,993044,462574,16153,0,0,0
236,2021-04-25,Emilia Romagna,14396,7517,451,0,0,0,1007440,470091,16604,0,0,0
238,2021-04-26,Emilia Romagna,18039,9325,569,0,0,0,1025479,479416,17173,0,0,0
240,2021-04-27,Emilia Romagna,19235,12468,441,0,0,0,1044714,491884,17614,0,0,0
242,2021-04-28,Emilia Romagna,20274,12900,604,0,0,0,1064988,504784,18218,0,0,0
244,2021-04-29,Emilia Romagna,26601,17566,836,0,0,0,1091589,522350,19054,0,0,0
246,2021-04-30,Emilia Romagna,21232,14814,628,0,0,0,1112821,537164,19682,0,0,0
248,2021-05-01,Emilia Romagna,15274,12802,370,0,0,0,1128095,549966,20052,0,0,0
250,2021-05-02,Emilia Romagna,13189,12005,412,0,0,0,1141284,561971,20464,0,0,0
252,2021-05-03,Emilia Romagna,17387,10887,470,0,0,0,1158671,572858,20934,0,0,0
254,2021-05-04,Emilia Romagna,15160,13683,494,0,0,0,1173831,586541,21428,0,0,0
256,2021-05-05,Emilia Romagna,18293,11280,585,0,0,0,1192124,597821,22013,0,0,0
258,2021-05-06,Emilia Romagna,22148,13114,742,0,0,0,1214272,610935,22755,0,0,0
260,2021-05-07,Emilia Romagna,22649,11905,806,0,0,0,1236921,622840,23561,0,0,0
262,2021-05-08,Emilia Romagna,20391,11450,556,0,0,0,1257312,634290,24117,0,0,0
264,2021-05-09,Emilia Romagna,18274,6980,403,0,0,0,1275586,641270,24520,0,0,0
266,2021-05-10,Emilia Romagna,25980,7270,660,0,0,0,1301566,648540,25180,0,0,0
268,2021-05-11,Emilia Romagna,27799,7272,761,0,0,0,1329365,655812,25941,0,0,0
270,2021-05-12,Emilia Romagna,28444,9716,823,0,0,0,1357809,665528,26764,0,0,0
272,2021-05-13,Emilia Romagna,27280,7867,749,0,0,0,1385089,673395,27513,0,0,0
274,2021-05-14,Emilia Romagna,26795,9664,921,0,0,0,1411884,683059,28434,0,0,0
276,2021-05-15,Emilia Romagna,22199,10445,660,0,0,0,1434083,693504,29094,0,0,0
278,2021-05-16,Emilia Romagna,18350,7160,395,0,0,0,1452433,700664,29489,0,0,0
280,2021-05-17,Emilia Romagna,22311,9571,616,0,0,0,1474744,710235,30105,0,0,0
282,2021-05-18,Emilia Romagna,18079,10657,511,0,0,0,1492823,720892,30616,0,0,0
284,2021-05-19,Emilia Romagna,18027,15275,555,0,0,0,1510850,736167,31171,0,0,0
286,2021-05-20,Emilia Romagna,18373,21511,542,0,0,0,1529223,757678,31713,0,0,0
288,2021-05-21,Emilia Romagna,21604,17144,652,0,0,0,1550827,774822,32365,0,0,0
290,2021-05-22,Emilia Romagna,16462,16265,470,0,0,0,1567289,791087,32835,0,0,0
292,2021-05-23,Emilia Romagna,13571,11610,329,0,0,0,1580860,802697,33164,0,0,0
294,2021-05-24,Emilia Romagna,17949,11531,543,0,0,0,1598809,814228,33707,0,0,0
296,2021-05-25,Emilia Romagna,11280,13536,442,0,0,0,1610089,827764,34149,0,0,0
298,2021-05-26,Emilia Romagna,9906,23060,395,0,0,0,1619995,850824,34544,0,0,0
300,2021-05-27,Emilia Romagna,13546,28307,522,0,0,0,1633541,879131,35066,0,0,0
302,2021-05-28,Emilia Romagna,17261,23449,618,0,0,0,1650802,902580,35684,0,0,0
304,2021-05-29,Emilia Romagna,16643,20782,545,0,0,0,1667445,923362,36229,0,0,0
306,2021-05-30,Emilia Romagna,12975,13720,416,0,0,0,1680420,937082,36645,0,0,0
308,2021-05-31,Emilia Romagna,17726,11546,567,0,0,0,1698146,948628,37212,0,0,0
310,2021-06-01,Emilia Romagna,16825,9941,453,0,0,0,1714971,958569,37665,0,0,0
312,2021-06-02,Emilia Romagna,18666,4981,483,0,0,0,1733637,963550,38148,0,0,0
314,2021-06-03,Emilia Romagna,29670,7568,713,0,0,0,1763307,971118,38861,0,0,0
316,2021-06-04,Emilia Romagna,36778,8219,799,0,0,0,1800085,979337,39660,0,0,0
318,2021-06-05,Emilia Romagna,36601,6938,824,0,0,0,1836686,986275,40484,0,0,0
320,2021-06-06,Emilia Romagna,31502,4418,698,0,0,0,1868188,990693,41182,0,0,0
322,2021-06-07,Emilia Romagna,33410,6278,918,0,0,0,1901598,996971,42100,0,0,0
324,2021-06-08,Emilia Romagna,36766,7550,869,0,0,0,1938364,1004521,42969,0,0,0
326,2021-06-09,Emilia Romagna,35722,6451,1062,0,0,0,1974086,1010972,44031,0,0,0
328,2021-06-10,Emilia Romagna,38654,5396,1096,0,0,0,2012740,1016368,45127,0,0,0
330,2021-06-11,Emilia Romagna,38284,6569,1169,0,0,0,2051024,1022937,46296,0,0,0
332,2021-06-12,Emilia Romagna,35426,4917,1077,0,0,0,2086450,1027854,47373,0,0,0
334,2021-06-13,Emilia Romagna,23775,4289,727,0,0,0,2110225,1032143,48100,0,0,0
336,2021-06-14,Emilia Romagna,27417,13092,858,0,0,0,2137642,1045235,48958,0,0,0
338,2021-06-15,Emilia Romagna,27877,15075,947,0,0,0,2165519,1060310,49905,0,0,0
340,2021-06-16,Emilia Romagna,25219,19981,799,0,0,0,2190738,1080291,50704,0,0,0
342,2021-06-17,Emilia Romagna,21726,24249,759,0,0,0,2212464,1104540,51463,0,0,0
344,2021-06-18,Emilia Romagna,16239,25952,623,0,0,0,2228703,1130492,52086,0,0,0
346,2021-06-19,Emilia Romagna,16720,19420,575,0,0,0,2245423,1149912,52661,0,0,0
348,2021-06-20,Emilia Romagna,15535,14690,542,0,0,0,2260958,1164602,53203,0,0,0
350,2021-06-21,Emilia Romagna,16044,20912,669,0,0,0,2277002,1185514,53872,0,0,0
352,2021-06-22,Emilia Romagna,16205,19660,700,0,0,0,2293207,1205174,54572,0,0,0
354,2021-06-23,Emilia Romagna,18417,18906,785,0,0,0,2311624,1224080,55357,0,0,0
356,2021-06-24,Emilia Romagna,20182,19582,904,0,0,0,2331806,1243662,56261,0,0,0
358,2021-06-25,Emilia Romagna,19670,22334,885,0,0,0,2351476,1265996,57146,0,0,0
360,2021-06-26,Emilia Romagna,20946,15559,1003,0,0,0,2372422,1281555,58149,0,0,0
362,2021-06-27,Emilia Romagna,16139,12743,729,0,0,0,2388561,1294298,58878,0,0,0
364,2021-06-28,Emilia Romagna,19518,19600,985,0,0,0,2408079,1313898,59863,0,0,0
366,2021-06-29,Emilia Romagna,18039,18800,899,0,0,0,2426118,1332698,60762,0,0,0
368,2021-06-30,Emilia Romagna,17630,15690,968,0,0,0,2443748,1348388,61730,0,0,0
370,2021-07-01,Emilia Romagna,14720,18877,965,0,0,0,2458468,1367265,62695,0,0,0
372,2021-07-02,Emilia Romagna,12321,21750,715,0,0,0,2470789,1389015,63410,0,0,0
374,2021-07-03,Emilia Romagna,11355,20036,755,0,0,0,2482144,1409051,64165,0,0,0
376,2021-07-04,Emilia Romagna,10131,13622,532,0,0,0,2492275,1422673,64697,0,0,0
378,2021-07-05,Emilia Romagna,11175,21402,697,0,0,0,2503450,1444075,65394,0,0,0
380,2021-07-06,Emilia Romagna,12852,23223,768,0,0,0,2516302,1467298,66162,0,0,0
382,2021-07-07,Emilia Romagna,13334,23755,862,0,0,0,2529636,1491053,67024,0,0,0
384,2021-07-08,Emilia Romagna,4679,36252,446,0,0,0,2534315,1527305,67470,0,0,0
386,2021-07-09,Emilia Romagna,5370,39146,453,0,0,0,2539685,1566451,67923,0,0,0
388,2021-07-10,Emilia Romagna,6769,34689,676,0,0,0,2546454,1601140,68599,0,0,0
390,2021-07-11,Emilia Romagna,2718,27417,278,0,0,0,2549172,1628557,68877,0,0,0
392,2021-07-12,Emilia Romagna,5395,38167,535,0,0,0,2554567,1666724,69412,0,0,0
394,2021-07-13,Emilia Romagna,6417,41405,724,0,0,0,2560984,1708129,70136,0,0,0
396,2021-07-14,Emilia Romagna,5567,41896,560,0,0,0,2566551,1750025,70696,0,0,0
398,2021-07-15,Emilia Romagna,7803,41857,775,0,0,0,2574354,1791882,71471,0,0,0
400,2021-07-16,Emilia Romagna,6978,42143,702,0,0,0,2581332,1834025,72173,0,0,0
402,2021-07-17,Emilia Romagna,7109,35794,797,0,0,0,2588441,1869819,72970,0,0,0
404,2021-07-18,Emilia Romagna,8155,25862,598,0,0,0,2596596,1895681,73568,0,0,0
406,2021-07-19,Emilia Romagna,6592,34811,636,0,0,0,2603188,1930492,74204,0,0,0
408,2021-07-20,Emilia Romagna,6581,35835,759,0,0,0,2609769,1966327,74963,0,0,0
410,2021-07-21,Emilia Romagna,10633,32324,766,0,0,0,2620402,1998651,75729,0,0,0
412,2021-07-22,Emilia Romagna,15071,24253,1101,0,0,0,2635473,2022904,76830,0,0,0
414,2021-07-23,Emilia Romagna,19662,19510,1290,0,0,0,2655135,2042414,78120,0,0,0
416,2021-07-24,Emilia Romagna,17064,20673,1171,0,0,0,2672199,2063087,79291,0,0,0
418,2021-07-25,Emilia Romagna,10456,17455,586,0,0,0,2682655,2080542,79877,0,0,0
420,2021-07-26,Emilia Romagna,15729,22910,964,0,0,0,2698384,2103452,80841,0,0,0
422,2021-07-27,Emilia Romagna,16856,23365,947,0,0,0,2715240,2126817,81788,0,0,0
424,2021-07-28,Emilia Romagna,13868,24072,795,0,0,0,2729108,2150889,82583,0,0,0
426,2021-07-29,Emilia Romagna,14379,25592,856,0,0,0,2743487,2176481,83439,0,0,0
428,2021-07-30,Emilia Romagna,15602,23496,812,0,0,0,2759089,2199977,84251,0,0,0
430,2021-07-31,Emilia Romagna,12033,23432,799,0,0,0,2771122,2223409,85050,0,0,0
432,2021-08-01,Emilia Romagna,10200,19422,469,0,0,0,2781322,2242831,85519,0,0,0
434,2021-08-02,Emilia Romagna,14720,23128,759,0,0,0,2796042,2265959,86278,0,0,0
436,2021-08-03,Emilia Romagna,15483,22329,750,0,0,0,2811525,2288288,87028,0,0,0
438,2021-08-04,Emilia Romagna,12978,21703,713,0,0,0,2824503,2309991,87741,0,0,0
440,2021-08-05,Emilia Romagna,18311,17435,1066,0,0,0,2842814,2327426,88807,0,0,0
442,2021-08-06,Emilia Romagna,18707,15003,1009,0,0,0,2861521,2342429,89816,0,0,0
444,2021-08-07,Emilia Romagna,17618,12236,1188,0,0,0,2879139,2354665,91004,0,0,0
446,2021-08-08,Emilia Romagna,10514,10518,628,0,0,0,2889653,2365183,91632,0,0,0
448,2021-08-09,Emilia Romagna,16559,12576,1178,0,0,0,2906212,2377759,92810,0,0,0
450,2021-08-10,Emilia Romagna,15292,14936,1148,0,0,0,2921504,2392695,93958,0,0,0
452,2021-08-11,Emilia Romagna,12025,14899,889,0,0,0,2933529,2407594,94847,0,0,0
454,2021-08-12,Emilia Romagna,19238,6886,1665,0,0,0,2952767,2414480,96512,0,0,0
456,2021-08-13,Emilia Romagna,14233,6093,983,0,0,0,2967000,2420573,97495,0,0,0
458,2021-08-14,Emilia Romagna,8288,7032,505,0,0,0,2975288,2427605,98000,0,0,0
460,2021-08-15,Emilia Romagna,3273,3204,194,0,0,0,2978561,2430809,98194,0,0,0
462,2021-08-16,Emilia Romagna,12602,6590,1090,0,0,0,2991163,2437399,99284,0,0,0
464,2021-08-17,Emilia Romagna,14488,6875,1104,0,0,0,3005651,2444274,100388,0,0,0
466,2021-08-18,Emilia Romagna,14556,6667,1131,0,0,0,3020207,2450941,101519,0,0,0
468,2021-08-19,Emilia Romagna,11909,8753,952,0,0,0,3032116,2459694,102471,0,0,0
470,2021-08-20,Emilia Romagna,10207,8544,1053,0,0,0,3042323,2468238,103524,0,0,0
472,2021-08-21,Emilia Romagna,10405,7807,951,0,0,0,3052728,2476045,104475,0,0,0
474,2021-08-22,Emilia Romagna,6720,9118,669,0,0,0,3059448,2485163,105144,0,0,0
476,2021-08-23,Emilia Romagna,11798,9498,1360,0,0,0,3071246,2494661,106504,0,0,0
478,2021-08-24,Emilia Romagna,10487,11805,1171,0,0,0,3081733,2506466,107675,0,0,0
480,2021-08-25,Emilia Romagna,9552,14652,1027,0,0,0,3091285,2521118,108702,0,0,0
482,2021-08-26,Emilia Romagna,9356,17356,1007,0,0,0,3100641,2538474,109709,0,0,0
484,2021-08-27,Emilia Romagna,6941,20278,774,0,0,0,3107582,2558752,110483,0,0,0
486,2021-08-28,Emilia Romagna,8588,16901,877,0,0,0,3116170,2575653,111360,0,0,0
488,2021-08-29,Emilia Romagna,8521,11289,909,0,0,0,3124691,2586942,112269,0,0,0
490,2021-08-30,Emilia Romagna,7619,18405,1074,0,0,0,3132310,2605347,113343,0,0,0
492,2021-08-31,Emilia Romagna,8333,18720,1098,0,0,0,3140643,2624067,114441,0,0,0
494,2021-09-01,Emilia Romagna,7170,14714,794,0,0,0,3147813,2638781,115235,0,0,0
496,2021-09-02,Emilia Romagna,6426,17916,761,0,0,0,3154239,2656697,115996,0,0,0
498,2021-09-03,Emilia Romagna,6290,16897,652,0,0,0,3160529,2673594,116648,0,0,0
500,2021-09-04,Emilia Romagna,8344,14524,967,0,0,0,3168873,2688118,117615,0,0,0
502,2021-09-05,Emilia Romagna,6424,10027,756,0,0,0,3175297,2698145,118371,0,0,0
504,2021-09-06,Emilia Romagna,6994,17547,873,0,0,0,3182291,2715692,119244,0,0,0
506,2021-09-07,Emilia Romagna,5807,19716,643,0,0,0,3188098,2735408,119887,0,0,0
508,2021-09-08,Emilia Romagna,5793,17144,667,0,0,0,3193891,2752552,120554,0,0,0
510,2021-09-09,Emilia Romagna,5158,19008,683,0,0,0,3199049,2771560,121237,0,0,0
512,2021-09-10,Emilia Romagna,5230,20320,728,0,0,0,3204279,2791880,121965,0,0,0
514,2021-09-11,Emilia Romagna,4517,19881,606,0,0,0,3208796,2811761,122571,0,0,0
516,2021-09-12,Emilia Romagna,3933,10474,482,0,0,0,3212729,2822235,123053,0,0,0
518,2021-09-13,Emilia Romagna,4724,18781,752,33,0,0,3217453,2841016,123805,33,0,0
520,2021-09-14,Emilia Romagna,4613,15401,583,43,0,0,3222066,2856417,124388,76,0,0
522,2021-09-15,Emilia Romagna,4613,14799,639,45,0,0,3226679,2871216,125027,121,0,0
524,2021-09-16,Emilia Romagna,3817,17898,486,77,0,0,3230496,2889114,125513,198,0,0
526,2021-09-17,Emilia Romagna,4450,13109,506,44,0,0,3234946,2902223,126019,242,0,0
528,2021-09-18,Emilia Romagna,8350,12582,915,43,0,0,3243296,2914805,126934,285,0,0
530,2021-09-19,Emilia Romagna,5647,9430,592,36,0,0,3248943,2924235,127526,321,0,0
532,2021-09-20,Emilia Romagna,5385,13779,502,391,0,0,3254328,2938014,128028,712,0,0
534,2021-09-21,Emilia Romagna,7085,11844,519,384,0,0,3261413,2949858,128547,1096,0,0
536,2021-09-22,Emilia Romagna,7295,11144,541,536,0,0,3268708,2961002,129088,1632,0,0
538,2021-09-23,Emilia Romagna,7185,9575,466,424,0,0,3275893,2970577,129554,2056,0,0
540,2021-09-24,Emilia Romagna,7486,8462,609,435,0,0,3283379,2979039,130163,2491,0,0
542,2021-09-25,Emilia Romagna,7351,10741,535,278,0,0,3290730,2989780,130698,2769,0,0
544,2021-09-26,Emilia Romagna,6077,7479,446,308,0,0,3296807,2997259,131144,3077,0,0
546,2021-09-27,Emilia Romagna,5711,10158,415,516,0,0,3302518,3007417,131559,3593,0,0
548,2021-09-28,Emilia Romagna,6099,8614,484,682,0,0,3308617,3016031,132043,4275,0,0
550,2021-09-29,Emilia Romagna,5678,6953,376,667,0,0,3314295,3022984,132419,4942,0,0
552,2021-09-30,Emilia Romagna,6480,7221,473,854,0,0,3320775,3030205,132892,5796,0,0
554,2021-10-01,Emilia Romagna,5276,6418,394,887,0,0,3326051,3036623,133286,6683,0,0
556,2021-10-02,Emilia Romagna,6570,6016,454,910,0,0,3332621,3042639,133740,7593,0,0
558,2021-10-03,Emilia Romagna,3488,4359,258,728,0,0,3336109,3046998,133998,8321,0,0
560,2021-10-04,Emilia Romagna,4046,5638,320,528,0,0,3340155,3052636,134318,8849,0,0
562,2021-10-05,Emilia Romagna,4309,5339,340,1256,1,0,3344464,3057975,134658,10105,1,0
564,2021-10-06,Emilia Romagna,4025,4413,310,1005,1,0,3348489,3062388,134968,11110,2,0
566,2021-10-07,Emilia Romagna,4344,3783,341,722,0,0,3352833,3066171,135309,11832,2,0
568,2021-10-08,Emilia Romagna,4784,4484,393,917,0,0,3357617,3070655,135702,12749,2,0
570,2021-10-09,Emilia Romagna,5427,7513,433,778,0,0,3363044,3078168,136135,13527,2,0
572,2021-10-10,Emilia Romagna,3347,5094,336,439,0,0,3366391,3083262,136471,13966,2,0
574,2021-10-11,Emilia Romagna,3289,5071,269,4700,0,0,3369680,3088333,136740,18666,2,0
576,2021-10-12,Emilia Romagna,4763,7131,329,4079,0,0,3374443,3095464,137069,22745,2,0
578,2021-10-13,Emilia Romagna,4446,6355,314,4869,0,0,3378889,3101819,137383,27614,2,0
580,2021-10-14,Emilia Romagna,5248,6602,323,4820,0,0,3384137,3108421,137706,32434,2,0
582,2021-10-15,Emilia Romagna,4473,7076,361,5083,0,0,3388610,3115497,138067,37517,2,0
584,2021-10-16,Emilia Romagna,3502,5699,324,3209,0,0,3392112,3121196,138391,40726,2,0
586,2021-10-17,Emilia Romagna,3131,7370,256,2773,0,0,3395243,3128566,138647,43499,2,0
588,2021-10-18,Emilia Romagna,3080,5629,253,6315,0,0,3398323,3134195,138900,49814,2,0
590,2021-10-19,Emilia Romagna,2474,4769,235,6798,0,0,3400797,3138964,139135,56612,2,0
592,2021-10-20,Emilia Romagna,2388,4438,283,5117,0,0,3403185,3143402,139418,61729,2,0
594,2021-10-21,Emilia Romagna,2421,5347,263,6639,0,0,3405606,3148749,139681,68368,2,0
596,2021-10-22,Emilia Romagna,2045,5298,296,6163,0,0,3407651,3154047,139977,74531,2,0
598,2021-10-23,Emilia Romagna,1747,5432,281,6186,0,0,3409398,3159479,140258,80717,2,0
600,2021-10-24,Emilia Romagna,1005,2494,127,2264,0,0,3410403,3161973,140385,82981,2,0
602,2021-10-25,Emilia Romagna,1518,3678,180,8563,0,0,3411921,3165651,140565,91544,2,0
604,2021-10-26,Emilia Romagna,1461,3985,180,8933,0,0,3413382,3169636,140745,100477,2,0
606,2021-10-27,Emilia Romagna,1225,3633,175,9159,0,0,3414607,3173269,140920,109636,2,0
608,2021-10-28,Emilia Romagna,1523,4380,208,10794,0,0,3416130,3177649,141128,120430,2,0
610,2021-10-29,Emilia Romagna,1321,4306,189,10425,0,0,3417451,3181955,141317,130855,2,0
612,2021-10-30,Emilia Romagna,1416,5229,223,8871,0,0,3418867,3187184,141540,139726,2,0
614,2021-10-31,Emilia Romagna,673,2735,134,3197,0,0,3419540,3189919,141674,142923,2,0
616,2021-11-01,Emilia Romagna,670,1820,77,2603,0,0,3420210,3191739,141751,145526,2,0
618,2021-11-02,Emilia Romagna,1015,4651,166,8889,0,0,3421225,3196390,141917,154415,2,0
620,2021-11-03,Emilia Romagna,913,3906,144,12073,0,0,3422138,3200296,142061,166488,2,0
622,2021-11-04,Emilia Romagna,1050,4235,145,12714,0,0,3423188,3204531,142206,179202,2,0
624,2021-11-05,Emilia Romagna,1013,3930,123,13943,0,0,3424201,3208461,142329,193145,2,0
626,2021-11-06,Emilia Romagna,1499,3625,198,11741,0,0,3425700,3212086,142527,204886,2,0
628,2021-11-07,Emilia Romagna,663,2442,89,4192,0,0,3426363,3214528,142616,209078,2,0
630,2021-11-08,Emilia Romagna,1006,2938,140,12490,0,0,3427369,3217466,142756,221568,2,0
632,2021-11-09,Emilia Romagna,1022,3183,98,13850,0,0,3428391,3220649,142854,235418,2,0
634,2021-11-10,Emilia Romagna,974,2621,105,13555,0,0,3429365,3223270,142959,248973,2,0
636,2021-11-11,Emilia Romagna,1129,3135,100,12920,0,0,3430494,3226405,143059,261893,2,0
638,2021-11-12,Emilia Romagna,947,2711,106,13992,0,0,3431441,3229116,143165,275885,2,0
640,2021-11-13,Emilia Romagna,1527,2381,151,13762,0,0,3432968,3231497,143316,289647,2,0
642,2021-11-14,Emilia Romagna,500,983,67,6284,0,0,3433468,3232480,143383,295931,2,0
644,2021-11-15,Emilia Romagna,1147,2022,123,14538,0,0,3434615,3234502,143506,310469,2,0
646,2021-11-16,Emilia Romagna,1023,1637,89,15606,0,0,3435638,3236139,143595,326075,2,0
648,2021-11-17,Emilia Romagna,921,1938,80,15519,0,0,3436559,3238077,143675,341594,2,0
650,2021-11-18,Emilia Romagna,1329,1698,100,16668,0,0,3437888,3239775,143775,358262,2,0
652,2021-11-19,Emilia Romagna,1159,1858,94,17453,0,0,3439047,3241633,143869,375715,2,0
654,2021-11-20,Emilia Romagna,1254,1762,105,16886,0,0,3440301,3243395,143974,392601,2,0
656,2021-11-21,Emilia Romagna,355,583,34,5299,0,0,3440656,3243978,144008,397900,2,0
658,2021-11-22,Emilia Romagna,1279,1600,95,20174,1,0,3441935,3245578,144103,418074,3,0
660,2021-11-23,Emilia Romagna,1455,1173,92,19919,0,0,3443390,3246751,144195,437993,3,0
662,2021-11-24,Emilia Romagna,1318,1169,98,21437,0,0,3444708,3247920,144293,459430,3,0
664,2021-11-25,Emilia Romagna,1894,1191,127,24604,0,0,3446602,3249111,144420,484034,3,0
666,2021-11-26,Emilia Romagna,1720,1101,136,25690,0,0,3448322,3250212,144556,509724,3,0
668,2021-11-27,Emilia Romagna,2013,1600,199,22780,0,0,3450335,3251812,144755,532504,3,0
670,2021-11-28,Emilia Romagna,645,498,70,8879,0,0,3450980,3252310,144825,541383,3,0
672,2021-11-29,Emilia Romagna,2070,1417,201,22993,0,0,3453050,3253727,145026,564376,3,0
674,2021-11-30,Emilia Romagna,1653,1289,141,25451,0,0,3454703,3255016,145167,589827,3,0
676,2021-12-01,Emilia Romagna,1683,941,167,24580,0,0,3456386,3255957,145334,614407,3,0
678,2021-12-02,Emilia Romagna,1803,1222,193,26978,0,0,3458189,3257179,145527,641385,3,0
680,2021-12-03,Emilia Romagna,2047,1106,208,30173,0,0,3460236,3258285,145735,671558,3,0
682,2021-12-04,Emilia Romagna,1559,1580,187,24202,0,0,3461795,3259865,145922,695760,3,0
684,2021-12-05,Emilia Romagna,1163,501,119,14635,0,0,3462958,3260366,146041,710395,3,0
686,2021-12-06,Emilia Romagna,2534,1392,292,28117,0,0,3465492,3261758,146333,738512,3,0
688,2021-12-07,Emilia Romagna,2430,1201,264,30888,0,0,3467922,3262959,146597,769400,3,0
690,2021-12-08,Emilia Romagna,1595,648,177,15259,0,0,3469517,3263607,146774,784659,3,0
692,2021-12-09,Emilia Romagna,2084,1528,246,33568,0,0,3471601,3265135,147020,818227,3,0
694,2021-12-10,Emilia Romagna,1737,1263,233,33727,0,0,3473338,3266398,147253,851954,3,0
696,2021-12-11,Emilia Romagna,1459,1450,203,29715,0,0,3474797,3267848,147456,881669,3,0
698,2021-12-12,Emilia Romagna,1268,585,164,19474,1,0,3476065,3268433,147620,901143,4,0
700,2021-12-13,Emilia Romagna,1643,1092,218,33939,0,0,3477708,3269525,147838,935082,4,0
702,2021-12-14,Emilia Romagna,1614,1011,250,36045,0,0,3479322,3270536,148088,971127,4,0
704,2021-12-15,Emilia Romagna,1514,911,237,37136,0,0,3480836,3271447,148325,1008263,4,0
706,2021-12-16,Emilia Romagna,2475,1080,266,36926,0,0,3483311,3272527,148591,1045189,4,0
708,2021-12-17,Emilia Romagna,2156,1032,256,36583,0,0,3485467,3273559,148847,1081772,4,0
710,2021-12-18,Emilia Romagna,2610,1148,280,34454,0,0,3488077,3274707,149127,1116226,4,0
712,2021-12-19,Emilia Romagna,2288,366,254,20276,0,0,3490365,3275073,149381,1136502,4,0
714,2021-12-20,Emilia Romagna,2555,1473,254,35736,0,0,3492920,3276546,149635,1172238,4,0
716,2021-12-21,Emilia Romagna,2441,1457,276,38073,0,0,3495361,3278003,149911,1210311,4,0
718,2021-12-22,Emilia Romagna,2528,1267,273,37609,0,0,3497889,3279270,150184,1247920,4,0
720,2021-12-23,Emilia Romagna,3494,1621,376,36065,0,0,3501383,3280891,150560,1283985,4,0
722,2021-12-24,Emilia Romagna,1394,855,173,22408,0,0,3502777,3281746,150733,1306393,4,0
724,2021-12-25,Emilia Romagna,97,98,19,4821,0,0,3502874,3281844,150752,1311214,4,0
726,2021-12-26,Emilia Romagna,407,244,84,14408,0,0,3503281,3282088,150836,1325622,4,0
728,2021-12-27,Emilia Romagna,3217,2987,451,37010,0,0,3506498,3285075,151287,1362632,4,0
730,2021-12-28,Emilia Romagna,4380,1955,499,38645,0,0,3510878,3287030,151786,1401277,4,0
732,2021-12-29,Emilia Romagna,3745,1606,428,39090,0,0,3514623,3288636,152214,1440367,4,0
734,2021-12-30,Emilia Romagna,3503,1524,438,38511,2,0,3518126,3290160,152652,1478878,6,0
736,2021-12-31,Emilia Romagna,1741,1030,206,24360,0,0,3519867,3291190,152858,1503238,6,0
738,2022-01-01,Emilia Romagna,313,177,56,7974,0,0,3520180,3291367,152914,1511212,6,0
740,2022-01-02,Emilia Romagna,1735,1646,293,24779,0,0,3521915,3293013,153207,1535991,6,0
742,2022-01-03,Emilia Romagna,3980,3156,549,36776,0,0,3525895,3296169,153756,1572767,6,0
744,2022-01-04,Emilia Romagna,5389,2334,747,37556,0,0,3531284,3298503,154503,1610323,6,0
746,2022-01-05,Emilia Romagna,3644,2134,578,38686,0,0,3534928,3300637,155081,1649009,6,0
748,2022-01-06,Emilia Romagna,2059,919,271,21091,0,0,3536987,3301556,155352,1670100,6,0
750,2022-01-07,Emilia Romagna,3821,3924,476,37209,0,0,3540808,3305480,155828,1707309,6,0
752,2022-01-08,Emilia Romagna,4764,2858,528,35942,0,0,3545572,3308338,156356,1743251,6,0
754,2022-01-09,Emilia Romagna,2649,2258,308,23424,0,0,3548221,3310596,156664,1766675,6,0
756,2022-01-10,Emilia Romagna,4271,3852,454,39975,0,0,3552492,3314448,157118,1806650,6,0
758,2022-01-11,Emilia Romagna,4700,3346,470,42849,0,0,3557192,3317794,157588,1849499,6,0
760,2022-01-12,Emilia Romagna,4204,3438,450,42295,0,0,3561396,3321232,158038,1891794,6,0
762,2022-01-13,Emilia Romagna,3815,3653,380,42847,0,0,3565211,3324885,158418,1934641,6,0
764,2022-01-14,Emilia Romagna,4113,2637,412,43785,2,0,3569324,3327522,158830,1978426,8,0
766,2022-01-15,Emilia Romagna,5365,2573,501,42001,0,0,3574689,3330095,159331,2020427,8,0
768,2022-01-16,Emilia Romagna,5912,1726,442,26945,0,0,3580601,3331821,159773,2047372,8,0
770,2022-01-17,Emilia Romagna,2919,3562,304,37239,0,0,3583520,3335383,160077,2084611,8,0
772,2022-01-18,Emilia Romagna,3274,4552,297,36688,0,0,3586794,3339935,160374,2121299,8,0
774,2022-01-19,Emilia Romagna,2711,3845,255,37541,0,0,3589505,3343780,160629,2158840,8,0
776,2022-01-20,Emilia Romagna,2420,4033,244,36668,0,0,3591925,3347813,160873,2195508,8,0
778,2022-01-21,Emilia Romagna,2784,2888,279,38900,0,0,3594709,3350701,161152,2234408,8,0
780,2022-01-22,Emilia Romagna,4830,1617,330,33101,1,0,3599539,3352318,161482,2267509,9,0
782,2022-01-23,Emilia Romagna,2864,1581,208,21039,0,0,3602403,3353899,161690,2288548,9,0
784,2022-01-24,Emilia Romagna,1979,4081,228,35212,0,0,3604382,3357980,161918,2323760,9,0
786,2022-01-25,Emilia Romagna,2105,5104,229,33792,0,0,3606487,3363084,162147,2357552,9,0
788,2022-01-26,Emilia Romagna,1988,3948,212,33479,0,0,3608475,3367032,162359,2391031,9,0
790,2022-01-27,Emilia Romagna,2358,3389,203,32389,0,0,3610833,3370421,162562,2423420,9,0
792,2022-01-28,Emilia Romagna,2381,3518,207,33608,0,0,3613214,3373939,162769,2457028,9,0
794,2022-01-29,Emilia Romagna,3659,4323,323,33356,0,0,3616873,3378262,163092,2490384,9,0
796,2022-01-30,Emilia Romagna,3393,2552,246,19446,0,0,3620266,3380814,163338,2509830,9,0
798,2022-01-31,Emilia Romagna,2306,3974,211,30043,0,0,3622572,3384788,163549,2539873,9,0
800,2022-02-01,Emilia Romagna,2371,4472,204,27656,0,0,3624943,3389260,163753,2567529,9,0
802,2022-02-02,Emilia Romagna,1414,3968,178,23298,0,0,3626357,3393228,163931,2590827,9,0
804,2022-02-03,Emilia Romagna,1482,3516,141,20996,0,0,3627839,3396744,164072,2611823,9,0
806,2022-02-04,Emilia Romagna,1435,4431,144,22875,0,0,3629274,3401175,164216,2634698,9,0
808,2022-02-05,Emilia Romagna,2962,5432,256,22521,1,0,3632236,3406607,164472,2657219,10,0
810,2022-02-06,Emilia Romagna,956,4601,126,12049,0,0,3633192,3411208,164598,2669268,10,0
812,2022-02-07,Emilia Romagna,1378,3847,161,17141,1,0,3634570,3415055,164759,2686409,11,0
814,2022-02-08,Emilia Romagna,1735,4853,137,15418,0,0,3636305,3419908,164896,2701827,11,0
816,2022-02-09,Emilia Romagna,1350,3443,97,13268,0,0,3637655,3423351,164993,2715095,11,0
818,2022-02-10,Emilia Romagna,1275,3207,148,13777,0,0,3638930,3426558,165141,2728872,11,0
820,2022-02-11,Emilia Romagna,988,3375,98,12563,0,0,3639918,3429933,165239,2741435,11,0
822,2022-02-12,Emilia Romagna,1775,4888,160,14052,0,0,3641693,3434821,165399,2755487,11,0
824,2022-02-13,Emilia Romagna,517,2859,69,6535,0,0,3642210,3437680,165468,2762022,11,0
826,2022-02-14,Emilia Romagna,669,2312,90,8487,0,0,3642879,3439992,165558,2770509,11,0
828,2022-02-15,Emilia Romagna,708,2481,115,8585,0,0,3643587,3442473,165673,2779094,11,0
830,2022-02-16,Emilia Romagna,574,2169,84,6740,0,0,3644161,3444642,165757,2785834,11,0
832,2022-02-17,Emilia Romagna,623,2746,97,6557,0,0,3644784,3447388,165854,2792391,11,0
834,2022-02-18,Emilia Romagna,568,2687,96,7436,0,0,3645352,3450075,165950,2799827,11,0
836,2022-02-19,Emilia Romagna,1002,3778,133,9100,0,0,3646354,3453853,166083,2808927,11,0
838,2022-02-20,Emilia Romagna,273,2972,56,3388,0,0,3646627,3456825,166139,2812315,11,0
840,2022-02-21,Emilia Romagna,309,2189,68,4758,0,0,3646936,3459014,166207,2817073,11,0
842,2022-02-22,Emilia Romagna,490,2515,85,4835,0,0,3647426,3461529,166292,2821908,11,0
844,2022-02-23,Emilia Romagna,270,1720,72,4971,0,0,3647696,3463249,166364,2826879,11,0
846,2022-02-24,Emilia Romagna,423,2291,62,5279,1,0,3648119,3465540,166426,2832158,12,0
848,2022-02-25,Emilia Romagna,318,1905,40,5867,0,0,3648437,3467445,166466,2838025,12,0
850,2022-02-26,Emilia Romagna,628,3690,122,8722,1,0,3649065,3471135,166588,2846747,13,0
852,2022-02-27,Emilia Romagna,73,1179,60,3359,1,0,3649138,3472314,166648,2850106,14,0
854,2022-02-28,Emilia Romagna,368,1743,64,4769,6,0,3649506,3474057,166712,2854875,20,0
856,2022-03-01,Emilia Romagna,336,1787,41,4441,790,0,3649842,3475844,166753,2859316,810,0
858,2022-03-02,Emilia Romagna,307,1524,35,3623,632,0,3650149,3477368,166788,2862939,1442,0
860,2022-03-03,Emilia Romagna,691,1870,78,4938,723,0,3650840,3479238,166866,2867877,2165,0
862,2022-03-04,Emilia Romagna,226,1101,52,4161,571,0,3651066,3480339,166918,2872038,2736,0
864,2022-03-05,Emilia Romagna,443,2267,71,5443,411,0,3651509,3482606,166989,2877481,3147,0
866,2022-03-06,Emilia Romagna,100,523,20,1329,261,0,3651609,3483129,167009,2878810,3408,0
868,2022-03-07,Emilia Romagna,241,1048,24,2762,165,0,3651850,3484177,167033,2881572,3573,0
870,2022-03-08,Emilia Romagna,267,1116,55,3894,287,0,3652117,3485293,167088,2885466,3860,0
872,2022-03-09,Emilia Romagna,216,705,33,3169,139,0,3652333,3485998,167121,2888635,3999,0
874,2022-03-10,Emilia Romagna,443,1192,63,5426,276,0,3652776,3487190,167184,2894061,4275,0
876,2022-03-11,Emilia Romagna,236,772,12,3613,371,0,3653012,3487962,167196,2897674,4646,0
878,2022-03-12,Emilia Romagna,414,1553,53,5797,266,0,3653426,3489515,167249,2903471,4912,0
880,2022-03-13,Emilia Romagna,52,278,7,1004,72,0,3653478,3489793,167256,2904475,4984,0
882,2022-03-14,Emilia Romagna,274,526,28,2332,176,0,3653752,3490319,167284,2906807,5160,0
884,2022-03-15,Emilia Romagna,313,852,55,3822,421,0,3654065,3491171,167339,2910629,5581,0
886,2022-03-16,Emilia Romagna,307,460,30,3002,177,0,3654372,3491631,167369,2913631,5758,0
888,2022-03-17,Emilia Romagna,372,926,43,4883,274,0,3654744,3492557,167412,2918514,6032,0
890,2022-03-18,Emilia Romagna,223,497,16,3085,360,0,3654967,3493054,167428,2921599,6392,0
892,2022-03-19,Emilia Romagna,286,1018,39,4723,154,0,3655253,3494072,167467,2926322,6546,0
894,2022-03-20,Emilia Romagna,45,198,2,751,18,0,3655298,3494270,167469,2927073,6564,0
896,2022-03-21,Emilia Romagna,213,542,24,2514,186,0,3655511,3494812,167493,2929587,6750,0
898,2022-03-22,Emilia Romagna,184,648,25,2964,218,0,3655695,3495460,167518,2932551,6968,0
900,2022-03-23,Emilia Romagna,149,425,24,1863,152,0,3655844,3495885,167542,2934414,7120,0
902,2022-03-24,Emilia Romagna,246,945,44,4212,215,0,3656090,3496830,167586,2938626,7335,0
904,2022-03-25,Emilia Romagna,151,487,16,3031,237,0,3656241,3497317,167602,2941657,7572,0
906,2022-03-26,Emilia Romagna,241,791,60,3982,161,0,3656482,3498108,167662,2945639,7733,0
908,2022-03-27,Emilia Romagna,41,176,6,847,16,0,3656523,3498284,167668,2946486,7749,0
910,2022-03-28,Emilia Romagna,131,343,15,2058,113,0,3656654,3498627,167683,2948544,7862,0
912,2022-03-29,Emilia Romagna,151,428,25,2458,216,0,3656805,3499055,167708,2951002,8078,0
914,2022-03-30,Emilia Romagna,108,304,16,1565,102,0,3656913,3499359,167724,2952567,8180,0
916,2022-03-31,Emilia Romagna,176,704,65,3114,151,0,3657089,3500063,167789,2955681,8331,0
918,2022-04-01,Emilia Romagna,99,270,11,1554,167,0,3657188,3500333,167800,2957235,8498,0
920,2022-04-02,Emilia Romagna,101,489,27,2579,160,0,3657289,3500822,167827,2959814,8658,0
922,2022-04-03,Emilia Romagna,1,13,0,68,0,0,3657290,3500835,167827,2959882,8658,0
924,2022-04-04,Emilia Romagna,77,331,15,1604,52,0,3657367,3501166,167842,2961486,8710,0
926,2022-04-05,Emilia Romagna,138,379,25,1992,114,0,3657505,3501545,167867,2963478,8824,0
928,2022-04-06,Emilia Romagna,103,313,22,1558,102,0,3657608,3501858,167889,2965036,8926,0
930,2022-04-07,Emilia Romagna,114,397,24,1908,74,0,3657722,3502255,167913,2966944,9000,0
932,2022-04-08,Emilia Romagna,67,263,11,1703,98,0,3657789,3502518,167924,2968647,9098,0
934,2022-04-09,Emilia Romagna,109,436,32,2528,104,0,3657898,3502954,167956,2971175,9202,0
936,2022-04-10,Emilia Romagna,7,23,2,75,2,0,3657905,3502977,167958,2971250,9204,0
938,2022-04-11,Emilia Romagna,116,375,76,1930,72,17,3658021,3503352,168034,2973180,9276,17
940,2022-04-12,Emilia Romagna,115,303,32,1976,89,15,3658136,3503655,168066,2975156,9365,32
942,2022-04-13,Emilia Romagna,78,244,19,1253,70,59,3658214,3503899,168085,2976409,9435,91
944,2022-04-14,Emilia Romagna,107,329,32,2240,188,495,3658321,3504228,168117,2978649,9623,586
946,2022-04-15,Emilia Romagna,59,259,8,1776,256,765,3658380,3504487,168125,2980425,9879,1351
948,2022-04-16,Emilia Romagna,44,194,8,1158,261,544,3658424,3504681,168133,2981583,10140,1895
950,2022-04-17,Emilia Romagna,0,1,0,22,0,1,3658424,3504682,168133,2981605,10140,1896
952,2022-04-18,Emilia Romagna,0,5,0,19,6,10,3658424,3504687,168133,2981624,10146,1906
954,2022-04-19,Emilia Romagna,97,270,40,1578,656,2719,3658521,3504957,168173,2983202,10802,4625
956,2022-04-20,Emilia Romagna,77,276,20,1332,607,2931,3658598,3505233,168193,2984534,11409,7556
958,2022-04-21,Emilia Romagna,79,236,55,1517,687,3370,3658677,3505469,168248,2986051,12096,10926
960,2022-04-22,Emilia Romagna,80,164,47,1132,560,2998,3658757,3505633,168295,2987183,12656,13924
962,2022-04-23,Emilia Romagna,46,178,14,1609,524,2584,3658803,3505811,168309,2988792,13180,16508
964,2022-04-24,Emilia Romagna,1,3,0,100,97,93,3658804,3505814,168309,2988892,13277,16601
966,2022-04-25,Emilia Romagna,0,3,0,28,20,95,3658804,3505817,168309,2988920,13297,16696
968,2022-04-26,Emilia Romagna,87,260,61,1464,757,4506,3658891,3506077,168370,2990384,14054,21202
970,2022-04-27,Emilia Romagna,71,189,26,1153,1093,4413,3658962,3506266,168396,2991537,15147,25615
972,2022-04-28,Emilia Romagna,82,234,25,1524,1079,4198,3659044,3506500,168421,2993061,16226,29813
974,2022-04-29,Emilia Romagna,72,153,39,973,949,3794,3659116,3506653,168460,2994034,17175,33607
976,2022-04-30,Emilia Romagna,71,170,60,1146,663,2584,3659187,3506823,168520,2995180,17838,36191
