,data,Regione,Dose1,Dose2,DoseUnica,Booster1,Booster3Dosi,Booster2,Dose1Cum,Dose2Cum,DoseUnicaCum,Booster1Cum,Booster3DosiCum,Booster2Cum
1,2020-12-27,Lombardia,718,0,1,0,0,0,718,0,1,0,0,0
3,2020-12-28,Lombardia,108,0,0,0,0,0,826,0,1,0,0,0
4,2020-12-29,Lombardia,107,0,0,0,0,0,933,0,1,0,0,0
6,2020-12-30,Lombardia,115,0,0,0,0,0,1048,0,1,0,0,0
8,2020-12-31,Lombardia,715,0,0,0,0,0,1763,0,1,0,0,0
9,2021-01-01,Lombardia,25,0,0,0,0,0,1788,0,1,0,0,0
11,2021-01-02,Lombardia,202,0,0,0,0,0,1990,0,1,0,0,0
13,2021-01-03,Lombardia,857,0,1,0,0,0,2847,0,2,0,0,0
15,2021-01-04,Lombardia,6133,0,9,0,0,0,8980,0,11,0,0,0
17,2021-01-05,Lombardia,7875,0,9,0,0,0,16855,0,20,0,0,0
19,2021-01-06,Lombardia,7166,0,7,0,0,0,24021,0,27,0,0,0
21,2021-01-07,Lombardia,11770,0,51,0,0,0,35791,0,78,0,0,0
23,2021-01-08,Lombardia,12739,0,25,0,0,0,48530,0,103,0,0,0
25,2021-01-09,Lombardia,12508,0,10,0,0,0,61038,0,113,0,0,0
27,2021-01-10,Lombardia,10543,0,13,0,0,0,71581,0,126,0,0,0
29,2021-01-11,Lombardia,16295,0,29,0,0,0,87876,0,155,0,0,0
31,2021-01-12,Lombardia,20305,0,45,0,0,0,108181,0,200,0,0,0
33,2021-01-13,Lombardia,26440,0,62,0,0,0,134621,0,262,0,0,0
35,2021-01-14,Lombardia,26912,0,83,0,0,0,161533,0,345,0,0,0
37,2021-01-15,Lombardia,25241,0,71,0,0,0,186774,0,416,0,0,0
39,2021-01-16,Lombardia,15640,0,33,0,0,0,202414,0,449,0,0,0
41,2021-01-17,Lombardia,8157,201,9,0,0,0,210571,201,458,0,0,0
43,2021-01-18,Lombardia,8284,976,16,0,0,0,218855,1177,474,0,0,0
45,2021-01-19,Lombardia,7581,471,20,0,0,0,226436,1648,494,0,0,0
47,2021-01-20,Lombardia,5602,115,7,0,0,0,232038,1763,501,0,0,0
49,2021-01-21,Lombardia,4823,695,19,0,0,0,236861,2458,520,0,0,0
51,2021-01-22,Lombardia,3195,69,6,0,0,0,240056,2527,526,0,0,0
53,2021-01-23,Lombardia,925,200,3,0,0,0,240981,2727,529,0,0,0
55,2021-01-24,Lombardia,538,664,0,0,0,0,241519,3391,529,0,0,0
57,2021-01-25,Lombardia,515,6621,4,0,0,0,242034,10012,533,0,0,0
59,2021-01-26,Lombardia,346,8056,1,0,0,0,242380,18068,534,0,0,0
61,2021-01-27,Lombardia,806,7271,2,0,0,0,243186,25339,536,0,0,0
63,2021-01-28,Lombardia,796,11491,8,0,0,0,243982,36830,544,0,0,0
65,2021-01-29,Lombardia,685,12869,4,0,0,0,244667,49699,548,0,0,0
67,2021-01-30,Lombardia,146,12212,8,0,0,0,244813,61911,556,0,0,0
69,2021-01-31,Lombardia,30,9800,0,0,0,0,244843,71711,556,0,0,0
71,2021-02-01,Lombardia,308,15831,2,0,0,0,245151,87542,558,0,0,0
73,2021-02-02,Lombardia,496,19528,4,0,0,0,245647,107070,562,0,0,0
75,2021-02-03,Lombardia,1078,24670,6,0,0,0,246725,131740,568,0,0,0
77,2021-02-04,Lombardia,2049,25998,4,0,0,0,248774,157738,572,0,0,0
79,2021-02-05,Lombardia,2430,23511,16,0,0,0,251204,181249,588,0,0,0
81,2021-02-06,Lombardia,1017,14305,3,0,0,0,252221,195554,591,0,0,0
83,2021-02-07,Lombardia,347,6989,3,0,0,0,252568,202543,594,0,0,0
85,2021-02-08,Lombardia,2124,8011,10,0,0,0,254692,210554,604,0,0,0
87,2021-02-09,Lombardia,4024,8197,21,0,0,0,258716,218751,625,0,0,0
89,2021-02-10,Lombardia,7565,6877,35,0,0,0,266281,225628,660,0,0,0
91,2021-02-11,Lombardia,9637,7432,82,0,0,0,275918,233060,742,0,0,0
93,2021-02-12,Lombardia,8861,5053,186,0,0,0,284779,238113,928,0,0,0
95,2021-02-13,Lombardia,4882,1480,68,0,0,0,289661,239593,996,0,0,0
97,2021-02-14,Lombardia,2929,637,20,0,0,0,292590,240230,1016,0,0,0
99,2021-02-15,Lombardia,8414,488,168,0,0,0,301004,240718,1184,0,0,0
101,2021-02-16,Lombardia,8994,456,89,0,0,0,309998,241174,1273,0,0,0
103,2021-02-17,Lombardia,10488,1390,180,0,0,0,320486,242564,1453,0,0,0
105,2021-02-18,Lombardia,12867,1039,163,0,0,0,333353,243603,1616,0,0,0
107,2021-02-19,Lombardia,13359,729,152,0,0,0,346712,244332,1768,0,0,0
109,2021-02-20,Lombardia,8887,335,156,0,0,0,355599,244667,1924,0,0,0
111,2021-02-21,Lombardia,4943,17,96,0,0,0,360542,244684,2020,0,0,0
113,2021-02-22,Lombardia,11493,310,160,0,0,0,372035,244994,2180,0,0,0
115,2021-02-23,Lombardia,11338,332,167,0,0,0,383373,245326,2347,0,0,0
117,2021-02-24,Lombardia,13610,958,162,0,0,0,396983,246284,2509,0,0,0
119,2021-02-25,Lombardia,13545,1624,194,0,0,0,410528,247908,2703,0,0,0
121,2021-02-26,Lombardia,16376,1912,167,0,0,0,426904,249820,2870,0,0,0
123,2021-02-27,Lombardia,13183,645,129,0,0,0,440087,250465,2999,0,0,0
125,2021-02-28,Lombardia,7606,210,70,0,0,0,447693,250675,3069,0,0,0
127,2021-03-01,Lombardia,16912,1709,186,0,0,0,464605,252384,3255,0,0,0
129,2021-03-02,Lombardia,19534,3052,264,0,0,0,484139,255436,3519,0,0,0
131,2021-03-03,Lombardia,19526,7322,195,0,0,0,503665,262758,3714,0,0,0
133,2021-03-04,Lombardia,20060,9093,231,0,0,0,523725,271851,3945,0,0,0
135,2021-03-05,Lombardia,20256,8452,309,0,0,0,543981,280303,4254,0,0,0
137,2021-03-06,Lombardia,16516,4522,333,0,0,0,560497,284825,4587,0,0,0
139,2021-03-07,Lombardia,9329,2563,210,0,0,0,569826,287388,4797,0,0,0
141,2021-03-08,Lombardia,22200,7135,504,0,0,0,592026,294523,5301,0,0,0
143,2021-03-09,Lombardia,25279,7428,575,0,0,0,617305,301951,5876,0,0,0
145,2021-03-10,Lombardia,24907,7921,561,0,0,0,642212,309872,6437,0,0,0
147,2021-03-11,Lombardia,25641,9978,691,0,0,0,667853,319850,7128,0,0,0
149,2021-03-12,Lombardia,24503,10273,586,0,0,0,692356,330123,7714,0,0,0
151,2021-03-13,Lombardia,20573,6125,549,0,0,0,712929,336248,8263,0,0,0
153,2021-03-14,Lombardia,11193,3290,404,0,0,0,724122,339538,8667,0,0,0
155,2021-03-15,Lombardia,22509,8594,552,0,0,0,746631,348132,9219,0,0,0
157,2021-03-16,Lombardia,16292,9116,143,0,0,0,762923,357248,9362,0,0,0
159,2021-03-17,Lombardia,15152,11071,170,0,0,0,778075,368319,9532,0,0,0
161,2021-03-18,Lombardia,15930,11313,247,0,0,0,794005,379632,9779,0,0,0
163,2021-03-19,Lombardia,18968,13290,277,0,0,0,812973,392922,10056,0,0,0
165,2021-03-20,Lombardia,22342,9864,493,0,0,0,835315,402786,10549,0,0,0
167,2021-03-21,Lombardia,17739,5200,587,0,0,0,853054,407986,11136,0,0,0
169,2021-03-22,Lombardia,29085,10586,724,0,0,0,882139,418572,11860,0,0,0
171,2021-03-23,Lombardia,28994,12932,779,0,0,0,911133,431504,12639,0,0,0
173,2021-03-24,Lombardia,30586,12116,855,0,0,0,941719,443620,13494,0,0,0
175,2021-03-25,Lombardia,29330,12902,866,0,0,0,971049,456522,14360,0,0,0
177,2021-03-26,Lombardia,27529,13208,675,0,0,0,998578,469730,15035,0,0,0
179,2021-03-27,Lombardia,23134,8780,628,0,0,0,1021712,478510,15663,0,0,0
181,2021-03-28,Lombardia,13960,6292,399,0,0,0,1035672,484802,16062,0,0,0
183,2021-03-29,Lombardia,24594,14875,639,0,0,0,1060266,499677,16701,0,0,0
185,2021-03-30,Lombardia,24303,14886,580,0,0,0,1084569,514563,17281,0,0,0
187,2021-03-31,Lombardia,26284,15404,616,0,0,0,1110853,529967,17897,0,0,0
189,2021-04-01,Lombardia,26195,16414,613,0,0,0,1137048,546381,18510,0,0,0
191,2021-04-02,Lombardia,26258,14661,513,0,0,0,1163306,561042,19023,0,0,0
193,2021-04-03,Lombardia,25888,10197,286,0,0,0,1189194,571239,19309,0,0,0
195,2021-04-04,Lombardia,3690,3902,26,0,0,0,1192884,575141,19335,0,0,0
197,2021-04-05,Lombardia,19130,8114,156,0,0,0,1212014,583255,19491,0,0,0
199,2021-04-06,Lombardia,24626,17966,528,0,0,0,1236640,601221,20019,0,0,0
201,2021-04-07,Lombardia,34238,15882,570,0,0,0,1270878,617103,20589,0,0,0
203,2021-04-08,Lombardia,35515,16527,467,0,0,0,1306393,633630,21056,0,0,0
205,2021-04-09,Lombardia,35886,16037,569,0,0,0,1342279,649667,21625,0,0,0
207,2021-04-10,Lombardia,40367,11993,519,0,0,0,1382646,661660,22144,0,0,0
209,2021-04-11,Lombardia,24513,7401,340,0,0,0,1407159,669061,22484,0,0,0
211,2021-04-12,Lombardia,32463,14465,491,0,0,0,1439622,683526,22975,0,0,0
213,2021-04-13,Lombardia,33124,14122,473,0,0,0,1472746,697648,23448,0,0,0
215,2021-04-14,Lombardia,33727,13000,533,0,0,0,1506473,710648,23981,0,0,0
217,2021-04-15,Lombardia,35077,13846,584,0,0,0,1541550,724494,24565,0,0,0
219,2021-04-16,Lombardia,38678,14409,662,0,0,0,1580228,738903,25227,0,0,0
221,2021-04-17,Lombardia,37213,10895,502,0,0,0,1617441,749798,25729,0,0,0
223,2021-04-18,Lombardia,30732,5248,480,0,0,0,1648173,755046,26209,0,0,0
225,2021-04-19,Lombardia,50014,9430,998,0,0,0,1698187,764476,27207,0,0,0
227,2021-04-20,Lombardia,56273,10373,1113,0,0,0,1754460,774849,28320,0,0,0
229,2021-04-21,Lombardia,56174,14713,1042,0,0,0,1810634,789562,29362,0,0,0
231,2021-04-22,Lombardia,56546,16470,1128,0,0,0,1867180,806032,30490,0,0,0
233,2021-04-23,Lombardia,55934,16677,1060,0,0,0,1923114,822709,31550,0,0,0
235,2021-04-24,Lombardia,53785,21180,935,0,0,0,1976899,843889,32485,0,0,0
237,2021-04-25,Lombardia,45863,4848,922,0,0,0,2022762,848737,33407,0,0,0
239,2021-04-26,Lombardia,67619,19172,1257,0,0,0,2090381,867909,34664,0,0,0
241,2021-04-27,Lombardia,68177,16629,1339,0,0,0,2158558,884538,36003,0,0,0
243,2021-04-28,Lombardia,67439,26975,1425,0,0,0,2225997,911513,37428,0,0,0
245,2021-04-29,Lombardia,83815,29946,1929,0,0,0,2309812,941459,39357,0,0,0
247,2021-04-30,Lombardia,87969,27706,1912,0,0,0,2397781,969165,41269,0,0,0
249,2021-05-01,Lombardia,65587,29350,1203,0,0,0,2463368,998515,42472,0,0,0
251,2021-05-02,Lombardia,59796,22491,1267,0,0,0,2523164,1021006,43739,0,0,0
253,2021-05-03,Lombardia,70085,12155,1550,0,0,0,2593249,1033161,45289,0,0,0
255,2021-05-04,Lombardia,70924,14441,1570,0,0,0,2664173,1047602,46859,0,0,0
257,2021-05-05,Lombardia,71128,15386,1672,0,0,0,2735301,1062988,48531,0,0,0
259,2021-05-06,Lombardia,71683,16608,1730,0,0,0,2806984,1079596,50261,0,0,0
261,2021-05-07,Lombardia,68434,22520,1574,0,0,0,2875418,1102116,51835,0,0,0
263,2021-05-08,Lombardia,64204,22159,1540,0,0,0,2939622,1124275,53375,0,0,0
265,2021-05-09,Lombardia,55156,13298,1302,0,0,0,2994778,1137573,54677,0,0,0
267,2021-05-10,Lombardia,62108,21611,1618,0,0,0,3056886,1159184,56295,0,0,0
269,2021-05-11,Lombardia,59132,26273,1592,0,0,0,3116018,1185457,57887,0,0,0
271,2021-05-12,Lombardia,58347,27626,1616,0,0,0,3174365,1213083,59503,0,0,0
273,2021-05-13,Lombardia,56660,28931,1677,0,0,0,3231025,1242014,61180,0,0,0
275,2021-05-14,Lombardia,54176,30388,1506,0,0,0,3285201,1272402,62686,0,0,0
277,2021-05-15,Lombardia,46345,33472,1211,0,0,0,3331546,1305874,63897,0,0,0
279,2021-05-16,Lombardia,35750,32237,756,0,0,0,3367296,1338111,64653,0,0,0
281,2021-05-17,Lombardia,29685,64460,573,0,0,0,3396981,1402571,65226,0,0,0
283,2021-05-18,Lombardia,32035,55613,631,0,0,0,3429016,1458184,65857,0,0,0
285,2021-05-19,Lombardia,33277,49396,658,0,0,0,3462293,1507580,66515,0,0,0
287,2021-05-20,Lombardia,31845,63109,693,0,0,0,3494138,1570689,67208,0,0,0
289,2021-05-21,Lombardia,28536,64805,617,0,0,0,3522674,1635494,67825,0,0,0
291,2021-05-22,Lombardia,31872,38263,582,0,0,0,3554546,1673757,68407,0,0,0
293,2021-05-23,Lombardia,26379,34017,435,0,0,0,3580925,1707774,68842,0,0,0
295,2021-05-24,Lombardia,48726,40100,811,0,0,0,3629651,1747874,69653,0,0,0
297,2021-05-25,Lombardia,43962,46565,720,0,0,0,3673613,1794439,70373,0,0,0
299,2021-05-26,Lombardia,42843,50184,795,0,0,0,3716456,1844623,71168,0,0,0
301,2021-05-27,Lombardia,40708,53635,703,0,0,0,3757164,1898258,71871,0,0,0
303,2021-05-28,Lombardia,42145,50798,808,0,0,0,3799309,1949056,72679,0,0,0
305,2021-05-29,Lombardia,41511,46170,729,0,0,0,3840820,1995226,73408,0,0,0
307,2021-05-30,Lombardia,33880,40024,537,0,0,0,3874700,2035250,73945,0,0,0
309,2021-05-31,Lombardia,78499,16268,996,0,0,0,3953199,2051518,74941,0,0,0
311,2021-06-01,Lombardia,75876,17149,1042,0,0,0,4029075,2068667,75983,0,0,0
313,2021-06-02,Lombardia,77103,6425,1208,0,0,0,4106178,2075092,77191,0,0,0
315,2021-06-03,Lombardia,84713,10954,1580,0,0,0,4190891,2086046,78771,0,0,0
317,2021-06-04,Lombardia,93335,9679,1664,0,0,0,4284226,2095725,80435,0,0,0
319,2021-06-05,Lombardia,91180,9848,1431,0,0,0,4375406,2105573,81866,0,0,0
321,2021-06-06,Lombardia,79559,9228,1362,0,0,0,4454965,2114801,83228,0,0,0
323,2021-06-07,Lombardia,84109,13392,1554,0,0,0,4539074,2128193,84782,0,0,0
325,2021-06-08,Lombardia,87264,14117,1597,0,0,0,4626338,2142310,86379,0,0,0
327,2021-06-09,Lombardia,87502,14618,1669,0,0,0,4713840,2156928,88048,0,0,0
329,2021-06-10,Lombardia,86446,14520,1784,0,0,0,4800286,2171448,89832,0,0,0
331,2021-06-11,Lombardia,85003,14712,1843,0,0,0,4885289,2186160,91675,0,0,0
333,2021-06-12,Lombardia,84376,3194,1777,0,0,0,4969665,2189354,93452,0,0,0
335,2021-06-13,Lombardia,72302,2132,1575,0,0,0,5041967,2191486,95027,0,0,0
337,2021-06-14,Lombardia,49157,44651,1094,0,0,0,5091124,2236137,96121,0,0,0
339,2021-06-15,Lombardia,49043,46022,1051,0,0,0,5140167,2282159,97172,0,0,0
341,2021-06-16,Lombardia,49856,48406,1154,0,0,0,5190023,2330565,98326,0,0,0
343,2021-06-17,Lombardia,50119,57417,1168,0,0,0,5240142,2387982,99494,0,0,0
345,2021-06-18,Lombardia,51779,54742,1240,0,0,0,5291921,2442724,100734,0,0,0
347,2021-06-19,Lombardia,56233,46769,1418,0,0,0,5348154,2489493,102152,0,0,0
349,2021-06-20,Lombardia,52761,35043,1260,0,0,0,5400915,2524536,103412,0,0,0
351,2021-06-21,Lombardia,78188,33082,2161,0,0,0,5479103,2557618,105573,0,0,0
353,2021-06-22,Lombardia,79145,29990,2161,0,0,0,5558248,2587608,107734,0,0,0
355,2021-06-23,Lombardia,76504,32354,2249,0,0,0,5634752,2619962,109983,0,0,0
357,2021-06-24,Lombardia,78272,29066,2485,0,0,0,5713024,2649028,112468,0,0,0
359,2021-06-25,Lombardia,78218,27693,2450,0,0,0,5791242,2676721,114918,0,0,0
361,2021-06-26,Lombardia,77674,25761,2519,0,0,0,5868916,2702482,117437,0,0,0
363,2021-06-27,Lombardia,69637,18889,2444,0,0,0,5938553,2721371,119881,0,0,0
365,2021-06-28,Lombardia,74126,31218,2791,0,0,0,6012679,2752589,122672,0,0,0
367,2021-06-29,Lombardia,57284,47943,2163,0,0,0,6069963,2800532,124835,0,0,0
369,2021-06-30,Lombardia,56420,48352,2284,0,0,0,6126383,2848884,127119,0,0,0
371,2021-07-01,Lombardia,53182,49442,2563,0,0,0,6179565,2898326,129682,0,0,0
373,2021-07-02,Lombardia,48754,53001,2323,0,0,0,6228319,2951327,132005,0,0,0
375,2021-07-03,Lombardia,44494,55896,2185,0,0,0,6272813,3007223,134190,0,0,0
377,2021-07-04,Lombardia,40091,44641,2061,0,0,0,6312904,3051864,136251,0,0,0
379,2021-07-05,Lombardia,31403,68571,1987,0,0,0,6344307,3120435,138238,0,0,0
381,2021-07-06,Lombardia,23060,77719,1452,0,0,0,6367367,3198154,139690,0,0,0
383,2021-07-07,Lombardia,17968,92952,1197,0,0,0,6385335,3291106,140887,0,0,0
385,2021-07-08,Lombardia,13221,100513,1038,0,0,0,6398556,3391619,141925,0,0,0
387,2021-07-09,Lombardia,11728,103199,902,0,0,0,6410284,3494818,142827,0,0,0
389,2021-07-10,Lombardia,13911,92199,1187,0,0,0,6424195,3587017,144014,0,0,0
391,2021-07-11,Lombardia,11756,77535,1070,0,0,0,6435951,3664552,145084,0,0,0
393,2021-07-12,Lombardia,14806,95985,1142,0,0,0,6450757,3760537,146226,0,0,0
395,2021-07-13,Lombardia,15435,92085,1256,0,0,0,6466192,3852622,147482,0,0,0
397,2021-07-14,Lombardia,14360,93720,1406,0,0,0,6480552,3946342,148888,0,0,0
399,2021-07-15,Lombardia,13370,94839,1205,0,0,0,6493922,4041181,150093,0,0,0
401,2021-07-16,Lombardia,11139,96635,1168,0,0,0,6505061,4137816,151261,0,0,0
403,2021-07-17,Lombardia,10217,97382,931,0,0,0,6515278,4235198,152192,0,0,0
405,2021-07-18,Lombardia,8528,87883,711,0,0,0,6523806,4323081,152903,0,0,0
407,2021-07-19,Lombardia,10802,85064,1090,0,0,0,6534608,4408145,153993,0,0,0
409,2021-07-20,Lombardia,6914,87392,751,0,0,0,6541522,4495537,154744,0,0,0
411,2021-07-21,Lombardia,8632,84564,859,0,0,0,6550154,4580101,155603,0,0,0
413,2021-07-22,Lombardia,12517,85486,1456,0,0,0,6562671,4665587,157059,0,0,0
415,2021-07-23,Lombardia,11442,82871,1247,0,0,0,6574113,4748458,158306,0,0,0
417,2021-07-24,Lombardia,9757,85285,846,0,0,0,6583870,4833743,159152,0,0,0
419,2021-07-25,Lombardia,9416,76448,789,0,0,0,6593286,4910191,159941,0,0,0
421,2021-07-26,Lombardia,7725,101169,751,0,0,0,6601011,5011360,160692,0,0,0
423,2021-07-27,Lombardia,7495,96781,695,0,0,0,6608506,5108141,161387,0,0,0
425,2021-07-28,Lombardia,19138,56614,1735,0,0,0,6627644,5164755,163122,0,0,0
427,2021-07-29,Lombardia,33760,38726,1977,0,0,0,6661404,5203481,165099,0,0,0
429,2021-07-30,Lombardia,35084,36117,2143,0,0,0,6696488,5239598,167242,0,0,0
431,2021-07-31,Lombardia,36345,32732,2051,0,0,0,6732833,5272330,169293,0,0,0
433,2021-08-01,Lombardia,27324,24278,1555,0,0,0,6760157,5296608,170848,0,0,0
435,2021-08-02,Lombardia,18327,64422,923,0,0,0,6778484,5361030,171771,0,0,0
437,2021-08-03,Lombardia,13483,71635,730,0,0,0,6791967,5432665,172501,0,0,0
439,2021-08-04,Lombardia,14500,75041,650,0,0,0,6806467,5507706,173151,0,0,0
441,2021-08-05,Lombardia,15764,73778,792,0,0,0,6822231,5581484,173943,0,0,0
443,2021-08-06,Lombardia,17832,66981,838,0,0,0,6840063,5648465,174781,0,0,0
445,2021-08-07,Lombardia,16092,62854,798,0,0,0,6856155,5711319,175579,0,0,0
447,2021-08-08,Lombardia,16692,41374,784,0,0,0,6872847,5752693,176363,0,0,0
449,2021-08-09,Lombardia,18644,49314,1048,0,0,0,6891491,5802007,177411,0,0,0
451,2021-08-10,Lombardia,18715,41703,1071,0,0,0,6910206,5843710,178482,0,0,0
453,2021-08-11,Lombardia,22493,37596,1318,0,0,0,6932699,5881306,179800,0,0,0
455,2021-08-12,Lombardia,22015,33539,1368,0,0,0,6954714,5914845,181168,0,0,0
457,2021-08-13,Lombardia,20560,31672,1241,0,0,0,6975274,5946517,182409,0,0,0
459,2021-08-14,Lombardia,11125,14867,560,0,0,0,6986399,5961384,182969,0,0,0
461,2021-08-15,Lombardia,2936,3887,180,0,0,0,6989335,5965271,183149,0,0,0
463,2021-08-16,Lombardia,16885,21109,1065,0,0,0,7006220,5986380,184214,0,0,0
465,2021-08-17,Lombardia,17403,14685,1198,0,0,0,7023623,6001065,185412,0,0,0
467,2021-08-18,Lombardia,17907,11659,1373,0,0,0,7041530,6012724,186785,0,0,0
469,2021-08-19,Lombardia,14767,13091,1136,0,0,0,7056297,6025815,187921,0,0,0
471,2021-08-20,Lombardia,14131,11914,1097,0,0,0,7070428,6037729,189018,0,0,0
473,2021-08-21,Lombardia,9489,11080,769,0,0,0,7079917,6048809,189787,0,0,0
475,2021-08-22,Lombardia,7589,10067,551,0,0,0,7087506,6058876,190338,0,0,0
477,2021-08-23,Lombardia,23742,30445,3321,0,0,0,7111248,6089321,193659,0,0,0
479,2021-08-24,Lombardia,24424,19463,3667,0,0,0,7135672,6108784,197326,0,0,0
481,2021-08-25,Lombardia,21625,19772,3144,0,0,0,7157297,6128556,200470,0,0,0
483,2021-08-26,Lombardia,20328,15564,2825,0,0,0,7177625,6144120,203295,0,0,0
485,2021-08-27,Lombardia,18518,14630,2617,0,0,0,7196143,6158750,205912,0,0,0
487,2021-08-28,Lombardia,17728,15049,2239,0,0,0,7213871,6173799,208151,0,0,0
489,2021-08-29,Lombardia,12717,11161,1318,0,0,0,7226588,6184960,209469,0,0,0
491,2021-08-30,Lombardia,43111,22424,5722,0,0,0,7269699,6207384,215191,0,0,0
493,2021-08-31,Lombardia,36643,21601,4605,0,0,0,7306342,6228985,219796,0,0,0
495,2021-09-01,Lombardia,30490,25974,3783,0,0,0,7336832,6254959,223579,0,0,0
497,2021-09-02,Lombardia,25753,27715,3042,0,0,0,7362585,6282674,226621,0,0,0
499,2021-09-03,Lombardia,22692,27568,2685,0,0,0,7385277,6310242,229306,0,0,0
501,2021-09-04,Lombardia,20488,22605,2572,0,0,0,7405765,6332847,231878,0,0,0
503,2021-09-05,Lombardia,12407,19470,1380,0,0,0,7418172,6352317,233258,0,0,0
505,2021-09-06,Lombardia,16494,37742,2060,0,0,0,7434666,6390059,235318,0,0,0
507,2021-09-07,Lombardia,15564,43395,2091,0,0,0,7450230,6433454,237409,0,0,0
509,2021-09-08,Lombardia,13501,42915,1770,0,0,0,7463731,6476369,239179,0,0,0
511,2021-09-09,Lombardia,11903,43143,1651,0,0,0,7475634,6519512,240830,0,0,0
513,2021-09-10,Lombardia,11408,39469,1811,0,0,0,7487042,6558981,242641,0,0,0
515,2021-09-11,Lombardia,13275,25982,1881,0,0,0,7500317,6584963,244522,0,0,0
517,2021-09-12,Lombardia,8959,16767,1228,0,0,0,7509276,6601730,245750,0,0,0
519,2021-09-13,Lombardia,6358,28891,1042,145,0,0,7515634,6630621,246792,145,0,0
521,2021-09-14,Lombardia,7483,28085,1167,170,0,0,7523117,6658706,247959,315,0,0
523,2021-09-15,Lombardia,8156,25389,1267,214,0,0,7531273,6684095,249226,529,0,0
525,2021-09-16,Lombardia,7895,20841,1246,172,0,0,7539168,6704936,250472,701,0,0
527,2021-09-17,Lombardia,9629,19317,1306,149,0,0,7548797,6724253,251778,850,0,0
529,2021-09-18,Lombardia,12793,19898,1499,105,0,0,7561590,6744151,253277,955,0,0
531,2021-09-19,Lombardia,10245,13737,1069,53,0,0,7571835,6757888,254346,1008,0,0
533,2021-09-20,Lombardia,11079,39367,1124,2342,0,0,7582914,6797255,255470,3350,0,0
535,2021-09-21,Lombardia,12444,32554,1189,2575,0,0,7595358,6829809,256659,5925,0,0
537,2021-09-22,Lombardia,13224,28372,1315,2306,0,0,7608582,6858181,257974,8231,0,0
539,2021-09-23,Lombardia,12905,24589,1232,1153,0,0,7621487,6882770,259206,9384,0,0
541,2021-09-24,Lombardia,12898,25276,1348,1053,0,0,7634385,6908046,260554,10437,0,0
543,2021-09-25,Lombardia,13128,24631,1282,369,0,0,7647513,6932677,261836,10806,0,0
545,2021-09-26,Lombardia,9104,14498,841,168,0,0,7656617,6947175,262677,10974,0,0
547,2021-09-27,Lombardia,12842,21771,1101,849,0,0,7669459,6968946,263778,11823,0,0
549,2021-09-28,Lombardia,12815,17451,1157,1074,0,0,7682274,6986397,264935,12897,0,0
551,2021-09-29,Lombardia,11049,16491,1151,1047,0,0,7693323,7002888,266086,13944,0,0
553,2021-09-30,Lombardia,11212,14839,1004,887,0,0,7704535,7017727,267090,14831,0,0
555,2021-10-01,Lombardia,10065,12454,1052,1056,0,0,7714600,7030181,268142,15887,0,0
557,2021-10-02,Lombardia,9013,13371,979,711,0,0,7723613,7043552,269121,16598,0,0
559,2021-10-03,Lombardia,5274,7860,539,316,0,0,7728887,7051412,269660,16914,0,0
561,2021-10-04,Lombardia,7863,10288,829,4812,0,0,7736750,7061700,270489,21726,0,0
563,2021-10-05,Lombardia,7570,8674,847,5064,0,0,7744320,7070374,271336,26790,0,0
565,2021-10-06,Lombardia,7546,8662,835,4476,0,0,7751866,7079036,272171,31266,0,0
567,2021-10-07,Lombardia,7904,8834,884,4225,0,0,7759770,7087870,273055,35491,0,0
569,2021-10-08,Lombardia,7655,11099,890,3777,0,0,7767425,7098969,273945,39268,0,0
571,2021-10-09,Lombardia,6797,10825,763,3448,0,0,7774222,7109794,274708,42716,0,0
573,2021-10-10,Lombardia,2970,5406,334,1792,0,0,7777192,7115200,275042,44508,0,0
575,2021-10-11,Lombardia,7188,14089,759,5460,0,0,7784380,7129289,275801,49968,0,0
577,2021-10-12,Lombardia,7509,12692,723,6530,0,0,7791889,7141981,276524,56498,0,0
579,2021-10-13,Lombardia,8396,13347,689,6630,0,0,7800285,7155328,277213,63128,0,0
581,2021-10-14,Lombardia,8664,12794,784,7193,0,0,7808949,7168122,277997,70321,0,0
583,2021-10-15,Lombardia,8042,12602,841,7276,0,0,7816991,7180724,278838,77597,0,0
585,2021-10-16,Lombardia,6563,10931,803,4482,0,0,7823554,7191655,279641,82079,0,0
587,2021-10-17,Lombardia,2944,6447,302,1988,0,0,7826498,7198102,279943,84067,0,0
589,2021-10-18,Lombardia,5552,15104,655,8899,0,0,7832050,7213206,280598,92966,0,0
591,2021-10-19,Lombardia,5276,13169,643,12830,0,0,7837326,7226375,281241,105796,0,0
593,2021-10-20,Lombardia,4897,11600,618,14881,0,0,7842223,7237975,281859,120677,0,0
595,2021-10-21,Lombardia,4670,10813,631,15132,0,0,7846893,7248788,282490,135809,0,0
597,2021-10-22,Lombardia,4480,10661,681,14529,0,0,7851373,7259449,283171,150338,0,0
599,2021-10-23,Lombardia,3029,9299,499,8532,0,0,7854402,7268748,283670,158870,0,0
601,2021-10-24,Lombardia,1047,3376,161,3728,0,0,7855449,7272124,283831,162598,0,0
603,2021-10-25,Lombardia,3719,10366,610,16463,0,0,7859168,7282490,284441,179061,0,0
605,2021-10-26,Lombardia,3288,8287,478,19368,0,0,7862456,7290777,284919,198429,0,0
607,2021-10-27,Lombardia,2869,7601,408,20564,0,0,7865325,7298378,285327,218993,0,0
609,2021-10-28,Lombardia,2620,7755,398,20953,0,0,7867945,7306133,285725,239946,0,0
611,2021-10-29,Lombardia,2379,7699,365,20208,0,0,7870324,7313832,286090,260154,0,0
613,2021-10-30,Lombardia,1852,5888,321,10681,0,0,7872176,7319720,286411,270835,0,0
615,2021-10-31,Lombardia,555,1839,93,3454,0,0,7872731,7321559,286504,274289,0,0
617,2021-11-01,Lombardia,964,3008,140,8450,0,0,7873695,7324567,286644,282739,0,0
619,2021-11-02,Lombardia,2448,7540,335,20447,0,0,7876143,7332107,286979,303186,0,0
621,2021-11-03,Lombardia,2287,6644,371,23428,0,0,7878430,7338751,287350,326614,0,0
623,2021-11-04,Lombardia,2250,6533,324,23628,0,0,7880680,7345284,287674,350242,0,0
625,2021-11-05,Lombardia,2464,6483,288,24319,0,0,7883144,7351767,287962,374561,0,0
627,2021-11-06,Lombardia,1832,5012,193,14179,0,0,7884976,7356779,288155,388740,0,0
629,2021-11-07,Lombardia,603,1616,78,5042,0,0,7885579,7358395,288233,393782,0,0
631,2021-11-08,Lombardia,2428,6808,335,25657,0,0,7888007,7365203,288568,419439,0,0
633,2021-11-09,Lombardia,2338,5813,260,28187,0,0,7890345,7371016,288828,447626,0,0
635,2021-11-10,Lombardia,2574,5259,260,28634,0,0,7892919,7376275,289088,476260,0,0
637,2021-11-11,Lombardia,2533,5544,232,27411,0,0,7895452,7381819,289320,503671,0,0
639,2021-11-12,Lombardia,2337,6113,208,27146,0,0,7897789,7387932,289528,530817,0,0
641,2021-11-13,Lombardia,1958,4390,192,17957,0,0,7899747,7392322,289720,548774,0,0
643,2021-11-14,Lombardia,696,1287,53,6182,0,0,7900443,7393609,289773,554956,0,0
645,2021-11-15,Lombardia,2247,4688,211,32534,0,0,7902690,7398297,289984,587490,0,0
647,2021-11-16,Lombardia,2259,4055,210,35928,0,0,7904949,7402352,290194,623418,0,0
649,2021-11-17,Lombardia,2265,3774,168,35484,0,0,7907214,7406126,290362,658902,0,0
651,2021-11-18,Lombardia,2377,3823,175,37063,0,0,7909591,7409949,290537,695965,0,0
653,2021-11-19,Lombardia,2353,3543,175,38323,0,0,7911944,7413492,290712,734288,0,0
655,2021-11-20,Lombardia,1906,2861,149,29307,0,0,7913850,7416353,290861,763595,0,0
657,2021-11-21,Lombardia,727,787,54,10038,0,0,7914577,7417140,290915,773633,0,0
659,2021-11-22,Lombardia,2609,2763,203,39185,0,0,7917186,7419903,291118,812818,0,0
661,2021-11-23,Lombardia,2550,2869,180,42612,0,0,7919736,7422772,291298,855430,0,0
663,2021-11-24,Lombardia,2637,3765,154,41785,0,0,7922373,7426537,291452,897215,0,0
665,2021-11-25,Lombardia,3044,2726,218,44208,0,0,7925417,7429263,291670,941423,0,0
667,2021-11-26,Lombardia,2854,2940,229,45847,0,0,7928271,7432203,291899,987270,0,0
669,2021-11-27,Lombardia,2546,2475,231,38928,0,0,7930817,7434678,292130,1026198,0,0
671,2021-11-28,Lombardia,993,731,69,13598,0,0,7931810,7435409,292199,1039796,0,0
673,2021-11-29,Lombardia,3846,2679,276,56400,0,0,7935656,7438088,292475,1096196,0,0
675,2021-11-30,Lombardia,3650,2721,334,59600,0,0,7939306,7440809,292809,1155796,0,0
677,2021-12-01,Lombardia,3476,2803,310,61897,0,0,7942782,7443612,293119,1217693,0,0
679,2021-12-02,Lombardia,3485,2653,307,74995,0,0,7946267,7446265,293426,1292688,0,0
681,2021-12-03,Lombardia,3410,2570,352,77266,0,0,7949677,7448835,293778,1369954,0,0
683,2021-12-04,Lombardia,3360,2423,333,73503,0,0,7953037,7451258,294111,1443457,0,0
685,2021-12-05,Lombardia,2211,976,230,52580,0,0,7955248,7452234,294341,1496037,0,0
687,2021-12-06,Lombardia,4481,2786,462,83854,0,0,7959729,7455020,294803,1579891,0,0
689,2021-12-07,Lombardia,4148,2318,418,84962,1,0,7963877,7457338,295221,1664853,1,0
691,2021-12-08,Lombardia,2010,687,225,57613,0,0,7965887,7458025,295446,1722466,1,0
693,2021-12-09,Lombardia,3798,4128,434,88309,0,0,7969685,7462153,295880,1810775,1,0
695,2021-12-10,Lombardia,4048,2733,480,92106,0,0,7973733,7464886,296360,1902881,1,0
697,2021-12-11,Lombardia,3477,1924,426,87363,0,0,7977210,7466810,296786,1990244,1,0
699,2021-12-12,Lombardia,2134,900,265,61236,0,0,7979344,7467710,297051,2051480,1,0
701,2021-12-13,Lombardia,3698,2557,457,95485,0,0,7983042,7470267,297508,2146965,1,0
703,2021-12-14,Lombardia,3811,2263,500,97687,0,0,7986853,7472530,298008,2244652,1,0
705,2021-12-15,Lombardia,3179,2016,398,96816,0,0,7990032,7474546,298406,2341468,1,0
707,2021-12-16,Lombardia,6801,2217,547,98419,0,0,7996833,7476763,298953,2439887,1,0
709,2021-12-17,Lombardia,6563,2229,529,96392,0,0,8003396,7478992,299482,2536279,1,0
711,2021-12-18,Lombardia,10595,1922,622,90776,0,0,8013991,7480914,300104,2627055,1,0
713,2021-12-19,Lombardia,10383,800,633,64693,0,0,8024374,7481714,300737,2691748,1,0
715,2021-12-20,Lombardia,7141,3102,561,97566,0,0,8031515,7484816,301298,2789314,1,0
717,2021-12-21,Lombardia,6892,2948,529,99488,0,0,8038407,7487764,301827,2888802,1,0
719,2021-12-22,Lombardia,7138,2938,560,98004,0,0,8045545,7490702,302387,2986806,1,0
721,2021-12-23,Lombardia,8125,2824,588,95822,0,0,8053670,7493526,302975,3082628,1,0
723,2021-12-24,Lombardia,3065,1252,192,50893,0,0,8056735,7494778,303167,3133521,1,0
725,2021-12-25,Lombardia,256,79,15,4045,0,0,8056991,7494857,303182,3137566,1,0
727,2021-12-26,Lombardia,4389,428,310,42241,0,0,8061380,7495285,303492,3179807,1,0
729,2021-12-27,Lombardia,8586,3970,732,92978,0,0,8069966,7499255,304224,3272785,1,0
731,2021-12-28,Lombardia,8646,3967,743,100033,0,0,8078612,7503222,304967,3372818,1,0
733,2021-12-29,Lombardia,8934,2953,744,99402,0,0,8087546,7506175,305711,3472220,1,0
735,2021-12-30,Lombardia,8603,2851,723,97550,0,0,8096149,7509026,306434,3569770,1,0
737,2021-12-31,Lombardia,3819,1372,311,55772,0,0,8099968,7510398,306745,3625542,1,0
739,2022-01-01,Lombardia,1051,250,96,8939,0,0,8101019,7510648,306841,3634481,1,0
741,2022-01-02,Lombardia,8564,1547,731,49939,0,0,8109583,7512195,307572,3684420,1,0
743,2022-01-03,Lombardia,9226,5004,832,89456,0,0,8118809,7517199,308404,3773876,1,0
745,2022-01-04,Lombardia,9724,4215,771,91469,0,0,8128533,7521414,309175,3865345,1,0
747,2022-01-05,Lombardia,8738,3269,737,93422,0,0,8137271,7524683,309912,3958767,1,0
749,2022-01-06,Lombardia,5607,3308,383,52785,0,0,8142878,7527991,310295,4011552,1,0
751,2022-01-07,Lombardia,9709,7348,682,87778,0,0,8152587,7535339,310977,4099330,1,0
753,2022-01-08,Lombardia,12429,10227,746,84037,0,0,8165016,7545566,311723,4183367,1,0
755,2022-01-09,Lombardia,10692,9818,642,58337,0,0,8175708,7555384,312365,4241704,1,0
757,2022-01-10,Lombardia,9791,8262,619,97314,0,0,8185499,7563646,312984,4339018,1,0
759,2022-01-11,Lombardia,10743,7516,612,96903,0,0,8196242,7571162,313596,4435921,1,0
761,2022-01-12,Lombardia,10054,7278,535,95770,0,0,8206296,7578440,314131,4531691,1,0
763,2022-01-13,Lombardia,9383,7902,491,94605,0,0,8215679,7586342,314622,4626296,1,0
765,2022-01-14,Lombardia,9663,6633,454,96028,0,0,8225342,7592975,315076,4722324,1,0
767,2022-01-15,Lombardia,15712,4046,650,92646,0,0,8241054,7597021,315726,4814970,1,0
769,2022-01-16,Lombardia,12840,4849,539,58064,0,0,8253894,7601870,316265,4873034,1,0
771,2022-01-17,Lombardia,7726,7730,353,89153,0,0,8261620,7609600,316618,4962187,1,0
773,2022-01-18,Lombardia,8023,7563,358,88737,0,0,8269643,7617163,316976,5050924,1,0
775,2022-01-19,Lombardia,7103,7721,333,85302,0,0,8276746,7624884,317309,5136226,1,0
777,2022-01-20,Lombardia,6171,7172,310,86471,0,0,8282917,7632056,317619,5222697,1,0
779,2022-01-21,Lombardia,6418,5615,272,85840,0,0,8289335,7637671,317891,5308537,1,0
781,2022-01-22,Lombardia,10354,3922,377,89032,0,0,8299689,7641593,318268,5397569,1,0
783,2022-01-23,Lombardia,8052,5949,264,51760,0,0,8307741,7647542,318532,5449329,1,0
785,2022-01-24,Lombardia,5443,7682,253,82584,0,0,8313184,7655224,318785,5531913,1,0
787,2022-01-25,Lombardia,5231,8167,228,83563,0,0,8318415,7663391,319013,5615476,1,0
789,2022-01-26,Lombardia,4808,7424,201,78939,0,0,8323223,7670815,319214,5694415,1,0
791,2022-01-27,Lombardia,4627,5972,190,77248,0,0,8327850,7676787,319404,5771663,1,0
793,2022-01-28,Lombardia,5219,7864,238,78012,0,0,8333069,7684651,319642,5849675,1,0
795,2022-01-29,Lombardia,10386,10697,354,82082,0,0,8343455,7695348,319996,5931757,1,0
797,2022-01-30,Lombardia,7676,9305,264,43258,0,0,8351131,7704653,320260,5975015,1,0
799,2022-01-31,Lombardia,4148,8425,225,65905,0,0,8355279,7713078,320485,6040920,1,0
801,2022-02-01,Lombardia,3407,9594,183,56249,0,0,8358686,7722672,320668,6097169,1,0
803,2022-02-02,Lombardia,2916,8934,159,51023,0,0,8361602,7731606,320827,6148192,1,0
805,2022-02-03,Lombardia,2445,7537,131,46763,0,0,8364047,7739143,320958,6194955,1,0
807,2022-02-04,Lombardia,2911,9594,126,47071,0,0,8366958,7748737,321084,6242026,1,0
809,2022-02-05,Lombardia,5908,14076,250,47544,0,0,8372866,7762813,321334,6289570,1,0
811,2022-02-06,Lombardia,3571,11916,108,20342,0,0,8376437,7774729,321442,6309912,1,0
813,2022-02-07,Lombardia,2156,9097,150,35734,0,0,8378593,7783826,321592,6345646,1,0
815,2022-02-08,Lombardia,1978,9234,101,32694,0,0,8380571,7793060,321693,6378340,1,0
817,2022-02-09,Lombardia,1590,7418,100,28509,0,0,8382161,7800478,321793,6406849,1,0
819,2022-02-10,Lombardia,1535,7071,89,28591,0,0,8383696,7807549,321882,6435440,1,0
821,2022-02-11,Lombardia,1779,7628,91,30631,0,0,8385475,7815177,321973,6466071,1,0
823,2022-02-12,Lombardia,3222,11459,163,29394,0,0,8388697,7826636,322136,6495465,1,0
825,2022-02-13,Lombardia,1624,8015,87,11297,0,0,8390321,7834651,322223,6506762,1,0
827,2022-02-14,Lombardia,915,6705,98,22071,0,0,8391236,7841356,322321,6528833,1,0
829,2022-02-15,Lombardia,970,5862,91,22188,0,0,8392206,7847218,322412,6551021,1,0
831,2022-02-16,Lombardia,927,5962,67,19039,0,0,8393133,7853180,322479,6570060,1,0
833,2022-02-17,Lombardia,749,5332,65,19378,1,0,8393882,7858512,322544,6589438,2,0
835,2022-02-18,Lombardia,981,5719,88,21327,0,0,8394863,7864231,322632,6610765,2,0
837,2022-02-19,Lombardia,1367,10006,125,22324,0,0,8396230,7874237,322757,6633089,2,0
839,2022-02-20,Lombardia,694,6833,57,8946,0,0,8396924,7881070,322814,6642035,2,0
841,2022-02-21,Lombardia,710,5197,63,19621,0,0,8397634,7886267,322877,6661656,2,0
843,2022-02-22,Lombardia,601,3927,67,16945,0,0,8398235,7890194,322944,6678601,2,0
845,2022-02-23,Lombardia,609,3097,65,14326,0,0,8398844,7893291,323009,6692927,2,0
847,2022-02-24,Lombardia,511,2661,53,14566,1,0,8399355,7895952,323062,6707493,3,0
849,2022-02-25,Lombardia,609,3676,58,17283,0,0,8399964,7899628,323120,6724776,3,0
851,2022-02-26,Lombardia,901,6105,109,19562,0,0,8400865,7905733,323229,6744338,3,0
853,2022-02-27,Lombardia,396,3859,45,7743,0,0,8401261,7909592,323274,6752081,3,0
855,2022-02-28,Lombardia,797,3150,93,16125,5,0,8402058,7912742,323367,6768206,8,0
857,2022-03-01,Lombardia,856,2104,71,9992,70,0,8402914,7914846,323438,6778198,78,0
859,2022-03-02,Lombardia,653,1695,60,8897,123,0,8403567,7916541,323498,6787095,201,0
861,2022-03-03,Lombardia,568,1459,50,9430,124,0,8404135,7918000,323548,6796525,325,0
863,2022-03-04,Lombardia,547,2120,63,11645,137,0,8404682,7920120,323611,6808170,462,0
865,2022-03-05,Lombardia,756,3969,104,13621,110,0,8405438,7924089,323715,6821791,572,0
867,2022-03-06,Lombardia,195,1234,39,4706,16,0,8405633,7925323,323754,6826497,588,0
869,2022-03-07,Lombardia,381,1417,39,10757,143,0,8406014,7926740,323793,6837254,731,0
871,2022-03-08,Lombardia,370,1180,38,9254,189,0,8406384,7927920,323831,6846508,920,0
873,2022-03-09,Lombardia,395,1049,40,8421,117,0,8406779,7928969,323871,6854929,1037,0
875,2022-03-10,Lombardia,419,1073,40,8686,245,0,8407198,7930042,323911,6863615,1282,0
877,2022-03-11,Lombardia,545,1455,72,11043,231,0,8407743,7931497,323983,6874658,1513,0
879,2022-03-12,Lombardia,672,1770,88,13313,420,0,8408415,7933267,324071,6887971,1933,0
881,2022-03-13,Lombardia,281,776,35,4284,61,0,8408696,7934043,324106,6892255,1994,0
883,2022-03-14,Lombardia,455,1152,32,9159,221,0,8409151,7935195,324138,6901414,2215,0
885,2022-03-15,Lombardia,382,855,36,8088,288,0,8409533,7936050,324174,6909502,2503,0
887,2022-03-16,Lombardia,392,721,28,7096,299,0,8409925,7936771,324202,6916598,2802,0
889,2022-03-17,Lombardia,410,703,24,7824,234,0,8410335,7937474,324226,6924422,3036,0
891,2022-03-18,Lombardia,468,1105,50,9257,237,0,8410803,7938579,324276,6933679,3273,0
893,2022-03-19,Lombardia,594,1159,74,11318,429,0,8411397,7939738,324350,6944997,3702,0
895,2022-03-20,Lombardia,181,340,19,2342,34,0,8411578,7940078,324369,6947339,3736,0
897,2022-03-21,Lombardia,404,1000,37,8173,269,0,8411982,7941078,324406,6955512,4005,0
899,2022-03-22,Lombardia,303,777,27,6304,181,0,8412285,7941855,324433,6961816,4186,0
901,2022-03-23,Lombardia,327,723,22,6096,219,0,8412612,7942578,324455,6967912,4405,0
903,2022-03-24,Lombardia,311,583,31,6608,267,0,8412923,7943161,324486,6974520,4672,0
905,2022-03-25,Lombardia,305,782,49,7872,264,0,8413228,7943943,324535,6982392,4936,0
907,2022-03-26,Lombardia,490,1101,84,9373,203,0,8413718,7945044,324619,6991765,5139,0
909,2022-03-27,Lombardia,184,433,28,2082,40,0,8413902,7945477,324647,6993847,5179,0
911,2022-03-28,Lombardia,251,662,34,6490,235,0,8414153,7946139,324681,7000337,5414,0
913,2022-03-29,Lombardia,278,505,28,6198,271,0,8414431,7946644,324709,7006535,5685,0
915,2022-03-30,Lombardia,298,499,50,5716,179,0,8414729,7947143,324759,7012251,5864,0
917,2022-03-31,Lombardia,271,458,20,5238,214,0,8415000,7947601,324779,7017489,6078,0
919,2022-04-01,Lombardia,240,445,43,5710,195,0,8415240,7948046,324822,7023199,6273,0
921,2022-04-02,Lombardia,334,708,114,6357,111,0,8415574,7948754,324936,7029556,6384,0
923,2022-04-03,Lombardia,103,202,41,1278,32,0,8415677,7948956,324977,7030834,6416,0
925,2022-04-04,Lombardia,187,611,39,4665,163,0,8415864,7949567,325016,7035499,6579,0
927,2022-04-05,Lombardia,187,319,29,4305,147,0,8416051,7949886,325045,7039804,6726,0
929,2022-04-06,Lombardia,205,426,39,4323,187,0,8416256,7950312,325084,7044127,6913,0
931,2022-04-07,Lombardia,174,386,25,4358,156,0,8416430,7950698,325109,7048485,7069,0
933,2022-04-08,Lombardia,181,564,43,5337,249,0,8416611,7951262,325152,7053822,7318,0
935,2022-04-09,Lombardia,268,654,99,6816,168,0,8416879,7951916,325251,7060638,7486,0
937,2022-04-10,Lombardia,79,170,69,1126,26,0,8416958,7952086,325320,7061764,7512,0
939,2022-04-11,Lombardia,170,465,45,4652,209,0,8417128,7952551,325365,7066416,7721,0
941,2022-04-12,Lombardia,146,338,36,4131,229,63,8417274,7952889,325401,7070547,7950,63
943,2022-04-13,Lombardia,179,336,58,4283,373,457,8417453,7953225,325459,7074830,8323,520
945,2022-04-14,Lombardia,206,339,54,4517,852,1997,8417659,7953564,325513,7079347,9175,2517
947,2022-04-15,Lombardia,147,407,42,4173,631,1752,8417806,7953971,325555,7083520,9806,4269
949,2022-04-16,Lombardia,141,317,80,3164,401,772,8417947,7954288,325635,7086684,10207,5041
951,2022-04-17,Lombardia,2,1,2,36,0,7,8417949,7954289,325637,7086720,10207,5048
953,2022-04-18,Lombardia,12,13,8,237,118,508,8417961,7954302,325645,7086957,10325,5556
955,2022-04-19,Lombardia,180,546,71,4049,1004,2685,8418141,7954848,325716,7091006,11329,8241
957,2022-04-20,Lombardia,149,360,64,3930,1346,3155,8418290,7955208,325780,7094936,12675,11396
959,2022-04-21,Lombardia,126,324,45,3350,1250,2680,8418416,7955532,325825,7098286,13925,14076
961,2022-04-22,Lombardia,165,350,63,3900,979,3476,8418581,7955882,325888,7102186,14904,17552
963,2022-04-23,Lombardia,229,504,134,3988,1104,2971,8418810,7956386,326022,7106174,16008,20523
965,2022-04-24,Lombardia,42,151,51,610,131,324,8418852,7956537,326073,7106784,16139,20847
967,2022-04-25,Lombardia,13,43,14,429,43,310,8418865,7956580,326087,7107213,16182,21157
969,2022-04-26,Lombardia,137,345,55,3006,993,3319,8419002,7956925,326142,7110219,17175,24476
971,2022-04-27,Lombardia,125,234,62,2851,1314,4047,8419127,7957159,326204,7113070,18489,28523
973,2022-04-28,Lombardia,103,221,35,2475,958,4111,8419230,7957380,326239,7115545,19447,32634
975,2022-04-29,Lombardia,143,225,80,2708,888,4401,8419373,7957605,326319,7118253,20335,37035
977,2022-04-30,Lombardia,175,374,157,3107,1438,3233,8419548,7957979,326476,7121360,21773,40268
